data,stato,codice_regione,denominazione_regione,lat,long,ricoverati_con_sintomi,terapia_intensiva,totale_ospedalizzati,isolamento_domiciliare,totale_positivi,variazione_totale_positivi,nuovi_positivi,dimessi_guariti,deceduti,totale_casi,tamponi,casi_testati,note_it,note_en,nuovi_ricoverati_con_sintomi,nuovi_terapia_intensiva,nuovi_totale_ospedalizzati,nuovi_isolamento_domiciliare,nuovi_dimessi_guariti,nuovi_deceduti,nuovi_totale_casi,nuovi_tamponi
2020-02-24T18:00:00,ITA,1,Piemonte,45.0732745,7.680687483,2,0,2,1,3,0,3,0,0,3,141,null,,,0,0,0,0,0,0,0,0
2020-02-25T18:00:00,ITA,1,Piemonte,45.0732745,7.680687483,2,0,2,1,3,0,0,0,0,3,141,null,,,2,0,2,1,0,0,3,141
2020-02-26T18:00:00,ITA,1,Piemonte,45.0732745,7.680687483,2,0,2,1,3,0,0,0,0,3,156,null,,,0,0,0,0,0,0,0,15
2020-02-27T18:00:00,ITA,1,Piemonte,45.0732745,7.680687483,2,0,2,0,2,-1,-1,0,0,2,156,null,,,0,0,0,-1,0,0,-1,0
2020-02-28T18:00:00,ITA,1,Piemonte,45.0732745,7.680687483,7,0,7,4,11,9,9,0,0,11,227,null,,,5,0,5,4,0,0,9,71
2020-02-29T17:00:00,ITA,1,Piemonte,45.0732745,7.680687483,7,0,7,4,11,0,0,0,0,11,308,null,,,0,0,0,0,0,0,0,81
2020-03-01T17:00:00,ITA,1,Piemonte,45.0732745,7.680687483,11,2,13,36,49,38,38,0,0,49,362,null,,,4,2,6,32,0,0,38,54
2020-03-02T18:00:00,ITA,1,Piemonte,45.0732745,7.680687483,12,2,14,37,51,2,2,0,0,51,434,null,,,1,0,1,1,0,0,2,72
2020-03-03T18:00:00,ITA,1,Piemonte,45.0732745,7.680687483,13,3,16,40,56,5,5,0,0,56,458,null,,,1,1,2,3,0,0,5,24
2020-03-04T17:00:00,ITA,1,Piemonte,45.0732745,7.680687483,26,13,39,43,82,26,26,0,0,82,543,null,,,13,10,23,3,0,0,26,85
2020-03-05T17:00:00,ITA,1,Piemonte,45.0732745,7.680687483,43,17,60,46,106,24,26,0,2,108,543,null,,,17,4,21,3,0,2,26,0
2020-03-06T17:00:00,ITA,1,Piemonte,45.0732745,7.680687483,57,30,87,52,139,33,35,0,4,143,793,null,,,14,13,27,6,0,2,35,250
2020-03-07T18:00:00,ITA,1,Piemonte,45.0732745,7.680687483,110,38,148,54,202,63,64,0,5,207,1046,null,,,53,8,61,2,0,1,64,253
2020-03-08T18:00:00,ITA,1,Piemonte,45.0732745,7.680687483,245,45,290,65,355,153,153,0,5,360,1636,null,,,135,7,142,11,0,0,153,590
2020-03-09T18:00:00,ITA,1,Piemonte,45.0732745,7.680687483,222,50,272,65,337,-18,-10,0,13,350,1681,null,,,-23,5,-18,0,0,8,-10,45
2020-03-10T18:00:00,ITA,1,Piemonte,45.0732745,7.680687483,306,66,372,64,436,99,103,0,17,453,2374,null,,,84,16,100,-1,0,4,103,693
2020-03-11T17:00:00,ITA,1,Piemonte,45.0732745,7.680687483,319,75,394,86,480,44,48,0,21,501,2431,null,,,13,9,22,22,0,4,48,57
2020-03-12T17:00:00,ITA,1,Piemonte,45.0732745,7.680687483,368,97,465,89,554,74,79,0,26,580,2879,null,,,49,22,71,3,0,5,79,448
2020-03-13T17:00:00,ITA,1,Piemonte,45.0732745,7.680687483,556,135,691,103,794,240,260,0,46,840,3105,null,,,188,38,226,14,0,20,260,226
2020-03-14T17:00:00,ITA,1,Piemonte,45.0732745,7.680687483,538,150,688,126,814,20,33,0,59,873,3680,null,,,-18,15,-3,23,0,13,33,575
2020-03-15T17:00:00,ITA,1,Piemonte,45.0732745,7.680687483,726,171,897,133,1030,216,238,0,81,1111,4375,null,,,188,21,209,7,0,22,238,695
2020-03-16T17:00:00,ITA,1,Piemonte,45.0732745,7.680687483,1045,186,1231,174,1405,375,405,0,111,1516,5588,null,,,319,15,334,41,0,30,405,1213
2020-03-17T17:00:00,ITA,1,Piemonte,45.0732745,7.680687483,1378,206,1584,180,1764,359,381,0,133,1897,6543,null,,,333,20,353,6,0,22,381,955
2020-03-18T17:00:00,ITA,1,Piemonte,45.0732745,7.680687483,1780,227,2007,180,2187,423,444,0,154,2341,7516,null,,,402,21,423,0,0,21,444,973
2020-03-19T17:00:00,ITA,1,Piemonte,45.0732745,7.680687483,2279,257,2536,218,2754,567,591,3,175,2932,8853,null,,,499,30,529,38,3,21,591,1337
2020-03-20T17:00:00,ITA,1,Piemonte,45.0732745,7.680687483,1541,280,1821,1423,3244,490,529,8,209,3461,9975,null,,,-738,23,-715,1205,5,34,529,1122
2020-03-21T17:00:00,ITA,1,Piemonte,45.0732745,7.680687483,1976,301,2277,1229,3506,262,291,8,238,3752,10701,null,,,435,21,456,-194,0,29,291,726
2020-03-22T17:00:00,ITA,1,Piemonte,45.0732745,7.680687483,2118,308,2426,1701,4127,621,668,10,283,4420,12701,null,,,142,7,149,472,2,45,668,2000
2020-03-23T17:00:00,ITA,1,Piemonte,45.0732745,7.680687483,2194,343,2537,1992,4529,402,441,17,315,4861,13560,null,,,76,35,111,291,7,32,441,859
2020-03-24T17:00:00,ITA,1,Piemonte,45.0732745,7.680687483,2404,360,2764,2360,5124,595,654,17,374,5515,15469,null,,,210,17,227,368,0,59,654,1909
2020-03-25T17:00:00,ITA,1,Piemonte,45.0732745,7.680687483,2544,381,2925,2631,5556,432,509,19,449,6024,16655,null,,,140,21,161,271,2,75,509,1186
2020-03-26T17:00:00,ITA,1,Piemonte,45.0732745,7.680687483,2633,408,3041,2909,5950,394,510,135,449,6534,18054,null,pd-IT-0006,pd-EN-0006,89,27,116,278,116,0,510,1399
2020-03-27T17:00:00,ITA,1,Piemonte,45.0732745,7.680687483,2852,431,3283,3064,6347,397,558,176,569,7092,19705,null,,,219,23,242,155,41,120,558,1651
2020-03-28T17:00:00,ITA,1,Piemonte,45.0732745,7.680687483,3094,439,3533,3318,6851,504,579,203,617,7671,21511,null,,,242,8,250,254,27,48,579,1806
2020-03-29T17:00:00,ITA,1,Piemonte,45.0732745,7.680687483,2985,443,3428,3840,7268,417,535,254,684,8206,24058,null,,,-109,4,-105,522,51,67,535,2547
2020-03-30T17:00:00,ITA,1,Piemonte,45.0732745,7.680687483,2985,452,3437,4218,7655,387,506,308,749,8712,25478,null,,,0,9,9,378,54,65,506,1420
2020-03-31T17:00:00,ITA,1,Piemonte,45.0732745,7.680687483,3174,452,3626,4456,8082,427,589,365,854,9301,27658,null,,,189,0,189,238,57,105,589,2180
2020-04-01T17:00:00,ITA,1,Piemonte,45.0732745,7.680687483,3146,453,3599,4871,8470,388,494,439,886,9795,30060,null,,,-28,1,-27,415,74,32,494,2402
2020-04-02T17:00:00,ITA,1,Piemonte,45.0732745,7.680687483,3341,453,3794,5005,8799,329,558,571,983,10353,32100,null,,,195,0,195,134,132,97,558,2040
2020-04-03T17:00:00,ITA,1,Piemonte,45.0732745,7.680687483,3300,452,3752,5378,9130,331,543,723,1043,10896,34281,null,,,-41,-1,-42,373,152,60,543,2181
2020-04-04T17:00:00,ITA,1,Piemonte,45.0732745,7.680687483,3441,450,3891,5802,9693,563,813,888,1128,11709,37181,null,,,141,-2,139,424,165,85,813,2900
2020-04-05T17:00:00,ITA,1,Piemonte,45.0732745,7.680687483,3472,444,3916,6261,10177,484,653,1017,1168,12362,38539,null,,,31,-6,25,459,129,40,653,1358
2020-04-06T17:00:00,ITA,1,Piemonte,45.0732745,7.680687483,3484,438,3922,6623,10545,368,562,1128,1251,12924,41123,null,,,12,-6,6,362,111,83,562,2584
2020-04-07T17:00:00,ITA,1,Piemonte,45.0732745,7.680687483,3553,432,3985,6719,10704,159,419,1320,1319,13343,44121,null,,,69,-6,63,96,192,68,419,2998
2020-04-08T17:00:00,ITA,1,Piemonte,45.0732745,7.680687483,3493,423,3916,7073,10989,285,540,1516,1378,13883,48495,null,,,-60,-9,-69,354,196,59,540,4374
2020-04-09T17:00:00,ITA,1,Piemonte,45.0732745,7.680687483,3514,412,3926,7410,11336,347,639,1732,1454,14522,52807,null,,,21,-11,10,337,216,76,639,4312
2020-04-10T17:00:00,ITA,1,Piemonte,45.0732745,7.680687483,3497,394,3891,7685,11576,240,490,1904,1532,15012,57457,null,,,-17,-18,-35,275,172,78,490,4650
2020-04-11T17:00:00,ITA,1,Piemonte,45.0732745,7.680687483,3435,384,3819,8351,12170,594,996,2205,1633,16008,62577,null,,,-62,-10,-72,666,301,101,996,5120
2020-04-12T17:00:00,ITA,1,Piemonte,45.0732745,7.680687483,3429,381,3810,8695,12505,335,652,2426,1729,16660,66555,null,,,-6,-3,-9,344,221,96,652,3978
2020-04-13T17:00:00,ITA,1,Piemonte,45.0732745,7.680687483,3344,379,3723,9042,12765,260,474,2543,1826,17134,69170,null,,,-85,-2,-87,347,117,97,474,2615
2020-04-14T17:00:00,ITA,1,Piemonte,45.0732745,7.680687483,3395,367,3762,9293,13055,290,556,2708,1927,17690,71678,null,,,51,-12,39,251,165,101,556,2508
2020-04-15T17:00:00,ITA,1,Piemonte,45.0732745,7.680687483,3338,366,3704,9491,13195,140,539,3019,2015,18229,75664,null,,,-57,-1,-58,198,311,88,539,3986
2020-04-16T17:00:00,ITA,1,Piemonte,45.0732745,7.680687483,3418,346,3764,10019,13783,588,879,3231,2094,19108,80708,null,,,80,-20,60,528,212,79,879,5044
2020-04-17T17:00:00,ITA,1,Piemonte,45.0732745,7.680687483,3266,333,3599,10399,13998,215,695,3634,2171,19803,86714,null,,,-152,-13,-165,380,403,77,695,6006
2020-04-18T17:00:00,ITA,1,Piemonte,45.0732745,7.680687483,3271,323,3594,10629,14223,225,661,3989,2252,20464,91844,null,,,5,-10,-5,230,355,81,661,5130
2020-04-19T17:00:00,ITA,1,Piemonte,45.0732745,7.680687483,3201,305,3506,10964,14470,247,593,4256,2331,21057,96569,71644,,,-70,-18,-88,335,267,79,593,4725
2020-04-20T17:00:00,ITA,1,Piemonte,45.0732745,7.680687483,3299,301,3600,10957,14557,87,292,4383,2409,21349,99669,73192,,,98,-4,94,-7,127,78,292,3100
2020-04-21T17:00:00,ITA,1,Piemonte,45.0732745,7.680687483,3116,293,3409,11402,14811,254,606,4659,2485,21955,105434,76406,,,-183,-8,-191,445,276,76,606,5765
2020-04-22T17:00:00,ITA,1,Piemonte,45.0732745,7.680687483,3213,273,3486,11636,15122,311,784,5058,2559,22739,111513,81176,,,97,-20,77,234,399,74,784,6079
2020-04-23T17:00:00,ITA,1,Piemonte,45.0732745,7.680687483,3039,261,3300,11852,15152,30,401,5358,2630,23140,117970,84648,,,-174,-12,-186,216,300,71,401,6457
2020-04-24T17:00:00,ITA,1,Piemonte,45.0732745,7.680687483,2918,257,3175,12216,15391,239,682,5732,2699,23822,125300,89392,,,-121,-4,-125,364,374,69,682,7330
2020-04-25T17:00:00,ITA,1,Piemonte,45.0732745,7.680687483,2937,238,3175,12327,15502,111,604,6157,2767,24426,131107,93325,,,19,-19,0,111,425,68,604,5807
2020-04-26T17:00:00,ITA,1,Piemonte,45.0732745,7.680687483,2866,214,3080,12439,15519,17,394,6478,2823,24820,135142,96977,,,-71,-24,-95,112,321,56,394,4035
2020-04-27T17:00:00,ITA,1,Piemonte,45.0732745,7.680687483,2830,214,3044,12464,15508,-11,278,6712,2878,25098,139348,99144,,,-36,0,-36,25,234,55,278,4206
2020-04-28T17:00:00,ITA,1,Piemonte,45.0732745,7.680687483,2701,202,2903,12603,15506,-2,352,7008,2936,25450,144531,102514,,,-129,-12,-141,139,296,58,352,5183
2020-04-29T17:00:00,ITA,1,Piemonte,45.0732745,7.680687483,2637,202,2839,12682,15521,15,411,7337,3003,25861,151266,106179,,,-64,0,-64,79,329,67,411,6735
2020-04-30T17:00:00,ITA,1,Piemonte,45.0732745,7.680687483,2621,199,2820,12673,15493,-28,428,7730,3066,26289,156534,110157,,,-16,-3,-19,-9,393,63,428,5268
2020-05-01T17:00:00,ITA,1,Piemonte,45.0732745,7.680687483,2503,181,2684,12878,15562,69,395,8025,3097,26684,162568,114786,,,-118,-18,-136,205,295,31,395,6034
2020-05-02T17:00:00,ITA,1,Piemonte,45.0732745,7.680687483,2550,178,2728,12991,15719,157,495,8334,3126,27179,168479,118814,,,47,-3,44,113,309,29,495,5911
2020-02-24T18:00:00,ITA,10,Umbria,43.10675841,12.38824698,0,0,0,0,0,0,0,0,0,0,0,null,,,0,0,0,0,0,0,0,0
2020-02-25T18:00:00,ITA,10,Umbria,43.10675841,12.38824698,0,0,0,0,0,0,0,0,0,0,8,null,,,0,0,0,0,0,0,0,8
2020-02-26T18:00:00,ITA,10,Umbria,43.10675841,12.38824698,0,0,0,0,0,0,0,0,0,0,8,null,,,0,0,0,0,0,0,0,0
2020-02-27T18:00:00,ITA,10,Umbria,43.10675841,12.38824698,0,0,0,0,0,0,0,0,0,0,8,null,,,0,0,0,0,0,0,0,0
2020-02-28T18:00:00,ITA,10,Umbria,43.10675841,12.38824698,0,0,0,0,0,0,0,0,0,0,8,null,,,0,0,0,0,0,0,0,0
2020-02-29T17:00:00,ITA,10,Umbria,43.10675841,12.38824698,0,0,0,0,0,0,0,0,0,0,31,null,,,0,0,0,0,0,0,0,23
2020-03-01T17:00:00,ITA,10,Umbria,43.10675841,12.38824698,0,0,0,2,2,2,2,0,0,2,35,null,,,0,0,0,2,0,0,2,4
2020-03-02T18:00:00,ITA,10,Umbria,43.10675841,12.38824698,0,0,0,2,2,0,0,0,0,2,35,null,,,0,0,0,0,0,0,0,0
2020-03-03T18:00:00,ITA,10,Umbria,43.10675841,12.38824698,1,1,2,6,8,6,6,0,0,8,45,null,,,1,1,2,4,0,0,6,10
2020-03-04T17:00:00,ITA,10,Umbria,43.10675841,12.38824698,1,1,2,7,9,1,1,0,0,9,58,null,,,0,0,0,1,0,0,1,13
2020-03-05T17:00:00,ITA,10,Umbria,43.10675841,12.38824698,1,1,2,7,9,0,0,0,0,9,88,null,,,0,0,0,0,0,0,0,30
2020-03-06T17:00:00,ITA,10,Umbria,43.10675841,12.38824698,2,2,4,12,16,7,7,0,0,16,110,null,,,1,1,2,5,0,0,7,22
2020-03-07T18:00:00,ITA,10,Umbria,43.10675841,12.38824698,2,2,4,20,24,8,8,0,0,24,134,null,,,0,0,0,8,0,0,8,24
2020-03-08T18:00:00,ITA,10,Umbria,43.10675841,12.38824698,2,2,4,22,26,2,2,0,0,26,168,null,,,0,0,0,2,0,0,2,34
2020-03-09T18:00:00,ITA,10,Umbria,43.10675841,12.38824698,4,2,6,22,28,2,2,0,0,28,183,null,,,2,0,2,0,0,0,2,15
2020-03-10T18:00:00,ITA,10,Umbria,43.10675841,12.38824698,8,2,10,27,37,9,9,0,0,37,260,null,,,4,0,4,5,0,0,9,77
2020-03-11T17:00:00,ITA,10,Umbria,43.10675841,12.38824698,7,5,12,32,44,7,9,2,0,46,340,null,,,-1,3,2,5,2,0,9,80
2020-03-12T17:00:00,ITA,10,Umbria,43.10675841,12.38824698,8,8,16,46,62,18,18,2,0,64,458,null,,,1,3,4,14,0,0,18,118
2020-03-13T17:00:00,ITA,10,Umbria,43.10675841,12.38824698,11,10,21,52,73,11,12,2,1,76,576,null,,,3,2,5,6,0,1,12,118
2020-03-14T17:00:00,ITA,10,Umbria,43.10675841,12.38824698,21,11,32,71,103,30,31,3,1,107,748,null,,,10,1,11,19,1,0,31,172
2020-03-15T17:00:00,ITA,10,Umbria,43.10675841,12.38824698,25,13,38,101,139,36,36,3,1,143,965,null,,,4,2,6,30,0,0,36,217
2020-03-16T17:00:00,ITA,10,Umbria,43.10675841,12.38824698,30,15,45,114,159,20,21,4,1,164,1093,null,,,5,2,7,13,1,0,21,128
2020-03-17T17:00:00,ITA,10,Umbria,43.10675841,12.38824698,36,21,57,135,192,33,33,4,1,197,1323,null,,,6,6,12,21,0,0,33,230
2020-03-18T17:00:00,ITA,10,Umbria,43.10675841,12.38824698,54,21,75,166,241,49,50,4,2,247,1601,null,,,18,0,18,31,0,1,50,278
2020-03-19T17:00:00,ITA,10,Umbria,43.10675841,12.38824698,69,21,90,238,328,87,87,4,2,334,1954,null,,,15,0,15,72,0,0,87,353
2020-03-20T17:00:00,ITA,10,Umbria,43.10675841,12.38824698,75,24,99,285,384,56,61,4,7,395,2303,null,,,6,3,9,47,0,5,61,349
2020-03-21T17:00:00,ITA,10,Umbria,43.10675841,12.38824698,92,29,121,326,447,63,67,5,10,462,2712,null,,,17,5,22,41,1,3,67,409
2020-03-22T17:00:00,ITA,10,Umbria,43.10675841,12.38824698,97,35,132,368,500,53,59,5,16,521,3135,null,,,5,6,11,42,0,6,59,423
2020-03-23T17:00:00,ITA,10,Umbria,43.10675841,12.38824698,106,42,148,408,556,56,56,5,16,577,3561,null,,,9,7,16,40,0,0,56,426
2020-03-24T17:00:00,ITA,10,Umbria,43.10675841,12.38824698,105,43,148,476,624,68,71,5,19,648,4108,null,,,-1,1,0,68,0,3,71,547
2020-03-25T17:00:00,ITA,10,Umbria,43.10675841,12.38824698,123,44,167,519,686,62,62,5,19,710,4707,null,,,18,1,19,43,0,0,62,599
2020-03-26T17:00:00,ITA,10,Umbria,43.10675841,12.38824698,144,46,190,580,770,84,92,12,20,802,5428,null,,,21,2,23,61,7,1,92,721
2020-03-27T17:00:00,ITA,10,Umbria,43.10675841,12.38824698,149,46,195,629,824,54,82,39,21,884,6137,null,,,5,0,5,49,27,1,82,709
2020-03-28T17:00:00,ITA,10,Umbria,43.10675841,12.38824698,159,44,203,695,898,74,85,43,28,969,7028,null,,,10,-2,8,66,4,7,85,891
2020-03-29T17:00:00,ITA,10,Umbria,43.10675841,12.38824698,166,46,212,685,897,-1,54,95,31,1023,7685,null,,,7,2,9,-10,52,3,54,657
2020-03-30T17:00:00,ITA,10,Umbria,43.10675841,12.38824698,173,47,220,614,834,-63,28,184,33,1051,8150,null,,,7,1,8,-71,89,2,28,465
2020-03-31T17:00:00,ITA,10,Umbria,43.10675841,12.38824698,176,43,219,632,851,17,27,190,37,1078,8685,null,,,3,-4,-1,18,6,4,27,535
2020-04-01T17:00:00,ITA,10,Umbria,43.10675841,12.38824698,173,45,218,646,864,13,17,194,37,1095,9080,null,,,-3,2,-1,14,4,0,17,395
2020-04-02T17:00:00,ITA,10,Umbria,43.10675841,12.38824698,171,47,218,667,885,21,33,205,38,1128,9737,null,,,-2,2,0,21,11,1,33,657
2020-04-03T17:00:00,ITA,10,Umbria,43.10675841,12.38824698,165,48,213,707,920,35,51,220,39,1179,10614,null,,,-6,1,-5,40,15,1,51,877
2020-04-04T17:00:00,ITA,10,Umbria,43.10675841,12.38824698,167,44,211,716,927,7,31,242,41,1210,11809,null,,,2,-4,-2,9,22,2,31,1195
2020-04-05T17:00:00,ITA,10,Umbria,43.10675841,12.38824698,159,45,204,694,898,-29,29,298,43,1239,12448,null,,,-8,1,-7,-22,56,2,29,639
2020-04-06T17:00:00,ITA,10,Umbria,43.10675841,12.38824698,159,46,205,667,872,-26,14,337,44,1253,12573,null,,,0,1,1,-27,39,1,14,125
2020-04-07T17:00:00,ITA,10,Umbria,43.10675841,12.38824698,157,41,198,648,846,-26,10,368,49,1263,13274,null,,,-2,-5,-7,-19,31,5,10,701
2020-04-08T17:00:00,ITA,10,Umbria,43.10675841,12.38824698,155,41,196,627,823,-23,26,416,50,1289,14105,null,,,-2,0,-2,-21,48,1,26,831
2020-04-09T17:00:00,ITA,10,Umbria,43.10675841,12.38824698,154,38,192,600,792,-31,9,455,51,1298,15170,null,,,-1,-3,-4,-27,39,1,9,1065
2020-04-10T17:00:00,ITA,10,Umbria,43.10675841,12.38824698,146,39,185,567,752,-40,4,498,52,1302,16325,null,,,-8,1,-7,-33,43,1,4,1155
2020-04-11T17:00:00,ITA,10,Umbria,43.10675841,12.38824698,137,39,176,547,723,-29,7,534,52,1309,17661,null,,,-9,0,-9,-20,36,0,7,1336
2020-04-12T17:00:00,ITA,10,Umbria,43.10675841,12.38824698,129,39,168,519,687,-36,10,580,52,1319,18672,null,,,-8,0,-8,-28,46,0,10,1011
2020-04-13T17:00:00,ITA,10,Umbria,43.10675841,12.38824698,127,38,165,460,625,-62,1,643,52,1320,18740,null,,,-2,-1,-3,-59,63,0,1,68
2020-04-14T17:00:00,ITA,10,Umbria,43.10675841,12.38824698,127,37,164,458,622,-3,1,646,53,1321,18956,null,,,0,-1,-1,-2,3,1,1,216
2020-04-15T17:00:00,ITA,10,Umbria,43.10675841,12.38824698,122,37,159,423,582,-40,1,686,54,1322,20258,null,,,-5,0,-5,-35,40,1,1,1302
2020-04-16T17:00:00,ITA,10,Umbria,43.10675841,12.38824698,116,33,149,387,536,-46,7,738,55,1329,21487,null,,,-6,-4,-10,-36,52,1,7,1229
2020-04-17T17:00:00,ITA,10,Umbria,43.10675841,12.38824698,111,31,142,352,494,-42,8,786,57,1337,22818,null,,,-5,-2,-7,-35,48,2,8,1331
2020-04-18T17:00:00,ITA,10,Umbria,43.10675841,12.38824698,109,32,141,290,431,-63,7,856,57,1344,24106,null,,,-2,1,-1,-62,70,0,7,1288
2020-04-19T17:00:00,ITA,10,Umbria,43.10675841,12.38824698,108,30,138,298,436,5,4,854,58,1348,25170,16790,,,-1,-2,-3,8,-2,1,4,1064
2020-04-20T17:00:00,ITA,10,Umbria,43.10675841,12.38824698,113,29,142,282,424,-12,1,867,58,1349,25562,17099,,,5,-1,4,-16,13,0,1,392
2020-04-21T17:00:00,ITA,10,Umbria,43.10675841,12.38824698,107,22,129,278,407,-17,4,886,60,1353,26639,17873,,,-6,-7,-13,-4,19,2,4,1077
2020-04-22T17:00:00,ITA,10,Umbria,43.10675841,12.38824698,97,20,117,254,371,-36,4,925,61,1357,27655,18679,,,-10,-2,-12,-24,39,1,4,1016
2020-04-23T17:00:00,ITA,10,Umbria,43.10675841,12.38824698,100,19,119,236,355,-16,5,946,61,1362,29011,19627,,,3,-1,2,-18,21,0,5,1356
2020-04-24T17:00:00,ITA,10,Umbria,43.10675841,12.38824698,94,19,113,209,322,-33,1,979,62,1363,30524,20733,,,-6,0,-6,-27,33,1,1,1513
2020-04-25T17:00:00,ITA,10,Umbria,43.10675841,12.38824698,95,18,113,184,297,-25,3,1006,63,1366,31939,21842,,,1,-1,0,-25,27,1,3,1415
2020-04-26T17:00:00,ITA,10,Umbria,43.10675841,12.38824698,91,17,108,188,296,-1,2,1008,64,1368,32569,22320,,,-4,-1,-5,4,2,1,2,630
2020-04-27T17:00:00,ITA,10,Umbria,43.10675841,12.38824698,90,16,106,181,287,-9,2,1018,65,1370,32823,22492,,,-1,-1,-2,-7,10,1,2,254
2020-04-28T17:00:00,ITA,10,Umbria,43.10675841,12.38824698,80,17,97,178,275,-12,9,1039,65,1379,33881,23263,,,-10,1,-9,-3,21,0,9,1058
2020-04-29T17:00:00,ITA,10,Umbria,43.10675841,12.38824698,77,16,93,168,261,-14,12,1064,66,1391,34937,24079,,,-3,-1,-4,-10,25,1,12,1056
2020-04-30T17:00:00,ITA,10,Umbria,43.10675841,12.38824698,68,16,84,149,233,-28,1,1092,67,1392,36459,25317,,,-9,0,-9,-19,28,1,1,1522
2020-05-01T17:00:00,ITA,10,Umbria,43.10675841,12.38824698,60,13,73,131,204,-29,1,1121,68,1393,37762,26285,,,-8,-3,-11,-18,29,1,1,1303
2020-05-02T17:00:00,ITA,10,Umbria,43.10675841,12.38824698,60,13,73,123,196,-8,1,1130,68,1394,38072,26463,,,0,0,0,-8,9,0,1,310
2020-02-24T18:00:00,ITA,11,Marche,43.61675973,13.5188753,0,0,0,0,0,0,0,0,0,0,16,null,,,0,0,0,0,0,0,0,0
2020-02-25T18:00:00,ITA,11,Marche,43.61675973,13.5188753,0,0,0,0,0,0,0,0,0,0,21,null,,,0,0,0,0,0,0,0,21
2020-02-26T18:00:00,ITA,11,Marche,43.61675973,13.5188753,1,0,1,0,1,1,1,0,0,1,28,null,,,1,0,1,0,0,0,1,7
2020-02-27T18:00:00,ITA,11,Marche,43.61675973,13.5188753,2,1,3,0,3,2,2,0,0,3,46,null,,,1,1,2,0,0,0,2,18
2020-02-28T18:00:00,ITA,11,Marche,43.61675973,13.5188753,3,2,5,1,6,3,3,0,0,6,47,null,,,1,1,2,1,0,0,3,1
2020-02-29T17:00:00,ITA,11,Marche,43.61675973,13.5188753,6,2,8,3,11,5,5,0,0,11,68,null,,,3,0,3,2,0,0,5,21
2020-03-01T17:00:00,ITA,11,Marche,43.61675973,13.5188753,12,5,17,8,25,14,14,0,0,25,101,null,,,6,3,9,5,0,0,14,33
2020-03-02T18:00:00,ITA,11,Marche,43.61675973,13.5188753,17,6,23,11,34,9,10,0,1,35,137,null,,,5,1,6,3,0,1,10,36
2020-03-03T18:00:00,ITA,11,Marche,43.61675973,13.5188753,27,13,40,19,59,25,26,0,2,61,200,null,,,10,7,17,8,0,1,26,63
2020-03-04T17:00:00,ITA,11,Marche,43.61675973,13.5188753,34,15,49,31,80,21,23,0,4,84,288,null,,,7,2,9,12,0,2,23,88
2020-03-05T17:00:00,ITA,11,Marche,43.61675973,13.5188753,57,19,76,44,120,40,40,0,4,124,413,null,,,23,4,27,13,0,0,40,125
2020-03-06T17:00:00,ITA,11,Marche,43.61675973,13.5188753,73,20,93,62,155,35,35,0,4,159,585,null,,,16,1,17,18,0,0,35,172
2020-03-07T18:00:00,ITA,11,Marche,43.61675973,13.5188753,94,36,130,71,201,46,48,0,6,207,816,null,,,21,16,37,9,0,2,48,231
2020-03-08T18:00:00,ITA,11,Marche,43.61675973,13.5188753,110,41,151,114,265,64,65,0,7,272,1025,null,,,16,5,21,43,0,1,65,209
2020-03-09T18:00:00,ITA,11,Marche,43.61675973,13.5188753,136,47,183,130,313,48,51,0,10,323,1250,null,,,26,6,32,16,0,3,51,225
2020-03-10T18:00:00,ITA,11,Marche,43.61675973,13.5188753,152,54,206,175,381,68,71,0,13,394,1437,null,,,16,7,23,45,0,3,71,187
2020-03-11T17:00:00,ITA,11,Marche,43.61675973,13.5188753,212,66,278,183,461,80,85,0,18,479,1656,null,,,60,12,72,8,0,5,85,219
2020-03-12T17:00:00,ITA,11,Marche,43.61675973,13.5188753,254,76,330,240,570,109,113,0,22,592,1907,null,,,42,10,52,57,0,4,113,251
2020-03-13T17:00:00,ITA,11,Marche,43.61675973,13.5188753,337,85,422,276,698,128,133,0,27,725,2218,null,,,83,9,92,36,0,5,133,311
2020-03-14T17:00:00,ITA,11,Marche,43.61675973,13.5188753,449,93,542,321,863,165,174,0,36,899,2561,null,,,112,8,120,45,0,9,174,343
2020-03-15T17:00:00,ITA,11,Marche,43.61675973,13.5188753,521,98,619,468,1087,224,234,0,46,1133,2946,null,,,72,5,77,147,0,10,234,385
2020-03-16T17:00:00,ITA,11,Marche,43.61675973,13.5188753,528,110,638,547,1185,98,109,0,57,1242,3225,null,,,7,12,19,79,0,11,109,279
2020-03-17T17:00:00,ITA,11,Marche,43.61675973,13.5188753,599,109,708,594,1302,117,129,0,69,1371,3225,null,,,71,-1,70,47,0,12,129,0
2020-03-18T17:00:00,ITA,11,Marche,43.61675973,13.5188753,638,119,757,719,1476,174,197,0,92,1568,4109,null,,,39,10,49,125,0,23,197,884
2020-03-19T17:00:00,ITA,11,Marche,43.61675973,13.5188753,656,141,797,825,1622,146,169,0,115,1737,4512,null,,,18,22,40,106,0,23,169,403
2020-03-20T17:00:00,ITA,11,Marche,43.61675973,13.5188753,704,138,842,1002,1844,222,244,0,137,1981,5170,null,,,48,-3,45,177,0,22,244,658
2020-03-21T17:00:00,ITA,11,Marche,43.61675973,13.5188753,742,141,883,1114,1997,153,172,2,154,2153,5740,null,,,38,3,41,112,2,17,172,570
2020-03-22T17:00:00,ITA,11,Marche,43.61675973,13.5188753,816,138,954,1277,2231,234,268,6,184,2421,6391,null,,,74,-3,71,163,4,30,268,651
2020-03-23T17:00:00,ITA,11,Marche,43.61675973,13.5188753,882,148,1030,1328,2358,127,148,8,203,2569,6782,null,,,66,10,76,51,2,19,148,391
2020-03-24T17:00:00,ITA,11,Marche,43.61675973,13.5188753,862,149,1011,1486,2497,139,167,8,231,2736,7229,null,,,-20,1,-19,158,0,28,167,447
2020-03-25T17:00:00,ITA,11,Marche,43.61675973,13.5188753,938,148,1086,1553,2639,142,198,8,287,2934,7896,null,,,76,-1,75,67,0,56,198,667
2020-03-26T17:00:00,ITA,11,Marche,43.61675973,13.5188753,977,166,1143,1652,2795,156,180,9,310,3114,8623,null,,,39,18,57,99,1,23,180,727
2020-03-27T17:00:00,ITA,11,Marche,43.61675973,13.5188753,979,162,1141,1709,2850,55,82,10,336,3196,9060,null,,,2,-4,-2,57,1,26,82,437
2020-03-28T17:00:00,ITA,11,Marche,43.61675973,13.5188753,987,166,1153,1846,2999,149,177,10,364,3373,9884,null,,,8,4,12,137,0,28,177,824
2020-03-29T17:00:00,ITA,11,Marche,43.61675973,13.5188753,1000,168,1168,1992,3160,161,185,12,386,3558,10431,null,,,13,2,15,146,2,22,185,547
2020-03-30T17:00:00,ITA,11,Marche,43.61675973,13.5188753,998,167,1165,2086,3251,91,126,16,417,3684,10979,null,,,-2,-1,-3,94,4,31,126,548
2020-03-31T17:00:00,ITA,11,Marche,43.61675973,13.5188753,946,169,1115,2237,3352,101,141,21,452,3825,11724,null,,,-52,2,-50,151,5,35,141,745
2020-04-01T17:00:00,ITA,11,Marche,43.61675973,13.5188753,984,168,1152,2304,3456,104,137,29,477,3962,12296,null,,,38,-1,37,67,8,25,137,572
2020-04-02T17:00:00,ITA,11,Marche,43.61675973,13.5188753,986,164,1150,2405,3555,99,136,40,503,4098,12943,null,,,2,-4,-2,101,11,26,136,647
2020-04-03T17:00:00,ITA,11,Marche,43.61675973,13.5188753,982,158,1140,2491,3631,76,132,42,557,4230,13678,null,,,-4,-6,-10,86,2,54,132,735
2020-04-04T17:00:00,ITA,11,Marche,43.61675973,13.5188753,997,153,1150,2347,3497,-134,111,270,574,4341,14472,null,,,15,-5,10,-144,228,17,111,794
2020-04-05T17:00:00,ITA,11,Marche,43.61675973,13.5188753,987,151,1138,2440,3578,81,123,287,599,4464,15252,null,,,-10,-2,-12,93,17,25,123,780
2020-04-06T17:00:00,ITA,11,Marche,43.61675973,13.5188753,1001,140,1141,2565,3706,128,150,296,612,4614,15919,null,,,14,-11,3,125,9,13,150,667
2020-04-07T17:00:00,ITA,11,Marche,43.61675973,13.5188753,962,139,1101,2637,3738,32,96,342,630,4710,16619,null,,,-39,-1,-40,72,46,18,96,700
2020-04-08T17:00:00,ITA,11,Marche,43.61675973,13.5188753,974,133,1107,2455,3562,-176,149,645,652,4859,17532,null,,,12,-6,6,-182,303,22,149,913
2020-04-09T17:00:00,ITA,11,Marche,43.61675973,13.5188753,945,133,1078,2323,3401,-161,96,885,669,4955,18194,null,,,-29,0,-29,-132,240,17,96,662
2020-04-10T17:00:00,ITA,11,Marche,43.61675973,13.5188753,925,127,1052,2264,3316,-85,129,1086,682,5084,18970,null,,,-20,-6,-26,-59,201,13,129,776
2020-04-11T17:00:00,ITA,11,Marche,43.61675973,13.5188753,960,118,1078,2153,3231,-85,127,1291,689,5211,20060,null,,,35,-9,26,-111,205,7,127,1090
2020-04-12T17:00:00,ITA,11,Marche,43.61675973,13.5188753,949,114,1063,2051,3114,-117,92,1489,700,5303,21057,null,,,-11,-4,-15,-102,198,11,92,997
2020-04-13T17:00:00,ITA,11,Marche,43.61675973,13.5188753,959,108,1067,2013,3080,-34,78,1588,713,5381,28379,null,,,10,-6,4,-38,99,13,78,7322
2020-04-14T17:00:00,ITA,11,Marche,43.61675973,13.5188753,937,106,1043,2052,3095,15,45,1603,728,5426,29160,null,,,-22,-2,-24,39,15,15,45,781
2020-04-15T17:00:00,ITA,11,Marche,43.61675973,13.5188753,888,106,994,2103,3097,2,77,1660,746,5503,30329,null,,,-49,0,-49,51,57,18,77,1169
2020-04-16T17:00:00,ITA,11,Marche,43.61675973,13.5188753,850,102,952,2172,3124,27,79,1694,764,5582,33778,null,,,-38,-4,-42,69,34,18,79,3449
2020-04-17T17:00:00,ITA,11,Marche,43.61675973,13.5188753,839,94,933,2224,3157,33,86,1726,785,5668,37997,null,,,-11,-8,-19,52,32,21,86,4219
2020-04-18T17:00:00,ITA,11,Marche,43.61675973,13.5188753,804,88,892,2280,3172,15,53,1754,795,5721,39909,null,,,-35,-6,-41,56,28,10,53,1912
2020-04-19T17:00:00,ITA,11,Marche,43.61675973,13.5188753,799,86,885,2297,3182,10,48,1780,807,5769,41474,27099,,,-5,-2,-7,17,26,12,48,1565
2020-04-20T17:00:00,ITA,11,Marche,43.61675973,13.5188753,792,80,872,2340,3212,30,57,1792,822,5826,42782,28006,,,-7,-6,-13,43,12,15,57,1308
2020-04-21T17:00:00,ITA,11,Marche,43.61675973,13.5188753,784,78,862,2356,3218,6,51,1825,834,5877,44332,29090,,,-8,-2,-10,16,33,12,51,1550
2020-04-22T17:00:00,ITA,11,Marche,43.61675973,13.5188753,735,76,811,2419,3230,12,47,1849,845,5924,46492,30543,,,-49,-2,-51,63,24,11,47,2160
2020-04-23T17:00:00,ITA,11,Marche,43.61675973,13.5188753,727,71,798,2432,3230,0,28,1865,857,5952,47662,31673,,,-8,-5,-13,13,16,12,28,1170
2020-04-24T17:00:00,ITA,11,Marche,43.61675973,13.5188753,705,61,766,2507,3273,43,76,1890,865,6028,49163,33113,,,-22,-10,-32,75,25,8,76,1501
2020-04-25T17:00:00,ITA,11,Marche,43.61675973,13.5188753,689,58,747,2525,3272,-1,30,1912,874,6058,50996,34256,,,-16,-3,-19,18,22,9,30,1833
2020-04-26T17:00:00,ITA,11,Marche,43.61675973,13.5188753,668,58,726,2582,3308,36,53,1924,879,6111,52063,35107,,,-21,0,-21,57,12,5,53,1067
2020-04-27T17:00:00,ITA,11,Marche,43.61675973,13.5188753,667,58,725,2585,3310,2,16,1933,884,6127,52765,35617,,,-1,0,-1,3,9,5,16,702
2020-04-28T17:00:00,ITA,11,Marche,43.61675973,13.5188753,666,58,724,2610,3334,24,48,1948,893,6175,54313,36650,,,-1,0,-1,25,15,9,48,1548
2020-04-29T17:00:00,ITA,11,Marche,43.61675973,13.5188753,640,52,692,2655,3347,13,35,1964,899,6210,55905,37877,,,-26,-6,-32,45,16,6,35,1592
2020-04-30T17:00:00,ITA,11,Marche,43.61675973,13.5188753,465,48,513,2697,3210,-137,37,2131,906,6247,59488,39145,,,-175,-4,-179,42,167,7,37,3583
2020-05-01T17:00:00,ITA,11,Marche,43.61675973,13.5188753,413,44,457,2754,3211,1,28,2153,911,6275,61241,40123,,,-52,-4,-56,57,22,5,28,1753
2020-05-02T17:00:00,ITA,11,Marche,43.61675973,13.5188753,399,46,445,2760,3205,-6,23,2177,916,6298,62834,41156,,,-14,2,-12,6,24,5,23,1593
2020-02-24T18:00:00,ITA,12,Lazio,41.89277044,12.48366722,1,1,2,0,2,0,2,1,0,3,124,null,,,0,0,0,0,0,0,0,0
2020-02-25T18:00:00,ITA,12,Lazio,41.89277044,12.48366722,1,1,2,0,2,0,0,1,0,3,124,null,,,1,1,2,0,1,0,3,124
2020-02-26T18:00:00,ITA,12,Lazio,41.89277044,12.48366722,0,0,0,0,0,-2,0,3,0,3,124,null,,,-1,-1,-2,0,2,0,0,0
2020-02-27T18:00:00,ITA,12,Lazio,41.89277044,12.48366722,0,0,0,0,0,0,0,3,0,3,552,null,,,0,0,0,0,0,0,0,428
2020-02-28T18:00:00,ITA,12,Lazio,41.89277044,12.48366722,0,0,0,0,0,0,0,3,0,3,611,null,,,0,0,0,0,0,0,0,59
2020-02-29T17:00:00,ITA,12,Lazio,41.89277044,12.48366722,3,0,3,0,3,3,3,3,0,6,679,null,,,3,0,3,0,0,0,3,68
2020-03-01T17:00:00,ITA,12,Lazio,41.89277044,12.48366722,3,0,3,0,3,0,0,3,0,6,724,null,,,0,0,0,0,0,0,0,45
2020-03-02T18:00:00,ITA,12,Lazio,41.89277044,12.48366722,3,0,3,1,4,1,1,3,0,7,773,null,,,0,0,0,1,0,0,1,49
2020-03-03T18:00:00,ITA,12,Lazio,41.89277044,12.48366722,10,0,10,1,11,7,7,3,0,14,877,null,,,7,0,7,0,0,0,7,104
2020-03-04T17:00:00,ITA,12,Lazio,41.89277044,12.48366722,15,3,18,9,27,16,16,3,0,30,995,null,,,5,3,8,8,0,0,16,118
2020-03-05T17:00:00,ITA,12,Lazio,41.89277044,12.48366722,20,7,27,14,41,14,14,3,0,44,1175,null,,,5,4,9,5,0,0,14,180
2020-03-06T17:00:00,ITA,12,Lazio,41.89277044,12.48366722,26,8,34,16,50,9,10,3,1,54,1373,null,,,6,1,7,2,0,1,10,198
2020-03-07T18:00:00,ITA,12,Lazio,41.89277044,12.48366722,43,8,51,21,72,22,22,3,1,76,1582,null,,,17,0,17,5,0,0,22,209
2020-03-08T18:00:00,ITA,12,Lazio,41.89277044,12.48366722,47,8,55,26,81,9,11,3,3,87,1929,null,,,4,0,4,5,0,2,11,347
2020-03-09T18:00:00,ITA,12,Lazio,41.89277044,12.48366722,55,8,63,31,94,13,15,3,5,102,1929,null,,,8,0,8,5,0,2,15,0
2020-03-10T18:00:00,ITA,12,Lazio,41.89277044,12.48366722,50,15,65,34,99,5,14,11,6,116,3591,null,,,-5,7,2,3,8,1,14,1662
2020-03-11T17:00:00,ITA,12,Lazio,41.89277044,12.48366722,67,18,85,40,125,26,34,19,6,150,3591,null,,,17,3,20,6,8,0,34,0
2020-03-12T17:00:00,ITA,12,Lazio,41.89277044,12.48366722,85,20,105,67,172,47,50,19,9,200,5592,null,,,18,2,20,27,0,3,50,2001
2020-03-13T17:00:00,ITA,12,Lazio,41.89277044,12.48366722,122,24,146,96,242,70,77,24,11,277,6491,null,,,37,4,41,29,5,2,77,899
2020-03-14T17:00:00,ITA,12,Lazio,41.89277044,12.48366722,181,25,206,114,320,78,80,24,13,357,7335,null,,,59,1,60,18,0,2,80,844
2020-03-15T17:00:00,ITA,12,Lazio,41.89277044,12.48366722,223,31,254,142,396,76,79,24,16,436,8345,null,,,42,6,48,28,0,3,79,1010
2020-03-16T17:00:00,ITA,12,Lazio,41.89277044,12.48366722,267,31,298,174,472,76,87,32,19,523,9330,null,,,44,0,44,32,8,3,87,985
2020-03-17T17:00:00,ITA,12,Lazio,41.89277044,12.48366722,314,44,358,192,550,78,84,34,23,607,9436,null,,,47,13,60,18,2,4,84,106
2020-03-18T17:00:00,ITA,12,Lazio,41.89277044,12.48366722,374,44,418,232,650,100,117,42,32,724,11145,null,,,60,0,60,40,8,9,117,1709
2020-03-19T17:00:00,ITA,12,Lazio,41.89277044,12.48366722,426,45,471,270,741,91,99,44,38,823,11145,null,,,52,1,53,38,2,6,99,0
2020-03-20T17:00:00,ITA,12,Lazio,41.89277044,12.48366722,537,47,584,328,912,171,185,53,43,1008,13889,null,,,111,2,113,58,9,5,185,2744
2020-03-21T17:00:00,ITA,12,Lazio,41.89277044,12.48366722,591,70,661,425,1086,174,182,54,50,1190,13889,null,,,54,23,77,97,1,7,182,0
2020-03-22T17:00:00,ITA,12,Lazio,41.89277044,12.48366722,671,79,750,522,1272,186,193,58,53,1383,17845,null,,,80,9,89,97,4,3,193,3956
2020-03-23T17:00:00,ITA,12,Lazio,41.89277044,12.48366722,718,96,814,600,1414,142,157,63,63,1540,18371,null,,,47,17,64,78,5,10,157,526
2020-03-24T17:00:00,ITA,12,Lazio,41.89277044,12.48366722,747,94,841,704,1545,131,188,103,80,1728,18371,null,,,29,-2,27,104,40,17,188,0
2020-03-25T17:00:00,ITA,12,Lazio,41.89277044,12.48366722,805,101,906,769,1675,130,173,131,95,1901,20669,null,,,58,7,65,65,28,15,173,2298
2020-03-26T17:00:00,ITA,12,Lazio,41.89277044,12.48366722,878,113,991,844,1835,160,195,155,106,2096,22771,null,,,73,12,85,75,24,11,195,2102
2020-03-27T17:00:00,ITA,12,Lazio,41.89277044,12.48366722,992,126,1118,895,2013,178,199,164,118,2295,24106,null,,,114,13,127,51,9,12,199,1335
2020-03-28T17:00:00,ITA,12,Lazio,41.89277044,12.48366722,985,133,1118,1063,2181,168,210,200,124,2505,27179,null,,,-7,7,0,168,36,6,210,3073
2020-03-29T17:00:00,ITA,12,Lazio,41.89277044,12.48366722,1062,133,1195,1167,2362,181,201,208,136,2706,27744,null,,,77,0,77,104,8,12,201,565
2020-03-30T17:00:00,ITA,12,Lazio,41.89277044,12.48366722,1079,154,1233,1264,2497,135,208,267,150,2914,32846,null,,,17,21,38,97,59,14,208,5102
2020-03-31T17:00:00,ITA,12,Lazio,41.89277044,12.48366722,1127,173,1300,1342,2642,145,181,291,162,3095,34677,null,,,48,19,67,78,24,12,181,1831
2020-04-01T17:00:00,ITA,12,Lazio,41.89277044,12.48366722,1131,177,1308,1450,2758,116,169,337,169,3264,35810,null,,,4,4,8,108,46,7,169,1133
2020-04-02T17:00:00,ITA,12,Lazio,41.89277044,12.48366722,1169,181,1350,1529,2879,121,169,369,185,3433,41575,null,,,38,4,42,79,32,16,169,5765
2020-04-03T17:00:00,ITA,12,Lazio,41.89277044,12.48366722,1194,188,1382,1627,3009,130,167,392,199,3600,43776,null,,,25,7,32,98,23,14,167,2201
2020-04-04T17:00:00,ITA,12,Lazio,41.89277044,12.48366722,1236,193,1429,1677,3106,97,157,439,212,3757,44624,null,,,42,5,47,50,47,13,157,848
2020-04-05T17:00:00,ITA,12,Lazio,41.89277044,12.48366722,1235,197,1432,1754,3186,80,123,475,219,3880,44658,null,,,-1,4,3,77,36,7,123,34
2020-04-06T17:00:00,ITA,12,Lazio,41.89277044,12.48366722,1235,197,1432,1868,3300,114,151,502,229,4031,47470,null,,,0,0,0,114,27,10,151,2812
2020-04-07T17:00:00,ITA,12,Lazio,41.89277044,12.48366722,1229,192,1421,1944,3365,65,118,546,238,4149,48874,null,,,-6,-5,-11,76,44,9,118,1404
2020-04-08T17:00:00,ITA,12,Lazio,41.89277044,12.48366722,1241,196,1437,2011,3448,83,117,574,244,4266,55113,null,,,12,4,16,67,28,6,117,6239
2020-04-09T17:00:00,ITA,12,Lazio,41.89277044,12.48366722,1244,198,1442,2090,3532,84,163,644,253,4429,58107,null,,,3,2,5,79,70,9,163,2994
2020-04-10T17:00:00,ITA,12,Lazio,41.89277044,12.48366722,1236,201,1437,2196,3633,101,154,687,263,4583,61769,null,,,-8,3,-5,106,43,10,154,3662
2020-04-11T17:00:00,ITA,12,Lazio,41.89277044,12.48366722,1264,203,1467,2263,3730,97,140,720,273,4723,65241,null,,,28,2,30,67,33,10,140,3472
2020-04-12T17:00:00,ITA,12,Lazio,41.89277044,12.48366722,1268,201,1469,2348,3817,87,122,749,279,4845,68954,null,,,4,-2,2,85,29,6,122,3713
2020-04-13T17:00:00,ITA,12,Lazio,41.89277044,12.48366722,1314,200,1514,2406,3920,103,123,764,284,4968,72746,null,,,46,-1,45,58,15,5,123,3792
2020-04-14T17:00:00,ITA,12,Lazio,41.89277044,12.48366722,1344,199,1543,2479,4022,102,143,789,300,5111,74650,null,,,30,-1,29,73,25,16,143,1904
2020-04-15T17:00:00,ITA,12,Lazio,41.89277044,12.48366722,1342,196,1538,2509,4047,25,121,874,311,5232,75584,null,,,-2,-3,-5,30,85,11,121,934
2020-04-16T17:00:00,ITA,12,Lazio,41.89277044,12.48366722,1347,197,1544,2600,4144,97,148,920,316,5380,81993,null,,,5,1,6,91,46,5,148,6409
2020-04-17T17:00:00,ITA,12,Lazio,41.89277044,12.48366722,1332,187,1519,2695,4214,70,144,978,332,5524,84755,null,,,-15,-10,-25,95,58,16,144,2762
2020-04-18T17:00:00,ITA,12,Lazio,41.89277044,12.48366722,1376,186,1562,2720,4282,68,144,1046,340,5668,89553,null,,,44,-1,43,25,68,8,144,4798
2020-04-19T17:00:00,ITA,12,Lazio,41.89277044,12.48366722,1370,185,1555,2766,4321,39,87,1093,341,5755,91807,22702,,,-6,-1,-7,46,47,1,87,2254
2020-04-20T17:00:00,ITA,12,Lazio,41.89277044,12.48366722,1388,185,1573,2792,4365,44,60,1101,349,5815,97823,23067,,,18,0,18,26,8,8,60,6016
2020-04-21T17:00:00,ITA,12,Lazio,41.89277044,12.48366722,1380,184,1564,2838,4402,37,80,1130,363,5895,100031,24046,,,-8,-1,-9,46,29,14,80,2208
2020-04-22T17:00:00,ITA,12,Lazio,41.89277044,12.48366722,1384,187,1571,2892,4463,61,80,1142,370,5975,104062,25244,,,4,3,7,54,12,7,80,4031
2020-04-23T17:00:00,ITA,12,Lazio,41.89277044,12.48366722,1385,186,1571,2915,4486,23,79,1193,375,6054,111073,26298,pd-IT-0016,pd-EN-0016,1,-1,0,23,51,5,79,7011
2020-04-24T17:00:00,ITA,12,Lazio,41.89277044,12.48366722,1396,184,1580,2912,4492,6,78,1256,384,6132,114317,86545,,,11,-2,9,-3,63,9,78,3244
2020-04-25T17:00:00,ITA,12,Lazio,41.89277044,12.48366722,1421,183,1604,2957,4561,69,92,1276,387,6224,118354,90582,,,25,-1,24,45,20,3,92,4037
2020-04-26T17:00:00,ITA,12,Lazio,41.89277044,12.48366722,1442,161,1603,2970,4573,12,85,1347,389,6309,121677,93811,,,21,-22,-1,13,71,2,85,3323
2020-04-27T17:00:00,ITA,12,Lazio,41.89277044,12.48366722,1464,143,1607,2955,4562,-11,83,1433,397,6392,124769,95719,,,22,-18,4,-15,86,8,83,3092
2020-04-28T17:00:00,ITA,12,Lazio,41.89277044,12.48366722,1468,132,1600,2962,4562,0,75,1491,414,6467,128664,98968,,,4,-11,-7,7,58,17,75,3895
2020-04-29T17:00:00,ITA,12,Lazio,41.89277044,12.48366722,1445,130,1575,2960,4535,-27,78,1579,431,6545,133503,103435,,,-23,-2,-25,-2,88,17,78,4839
2020-04-30T17:00:00,ITA,12,Lazio,41.89277044,12.48366722,1417,115,1532,2936,4468,-67,71,1707,441,6616,137596,107497,,,-28,-15,-43,-24,128,10,71,4093
2020-05-01T17:00:00,ITA,12,Lazio,41.89277044,12.48366722,1372,105,1477,2969,4446,-22,56,1744,482,6672,143804,111988,dc-IT-0014,dc-EN-0014,-45,-10,-55,33,37,41,56,6208
2020-05-02T17:00:00,ITA,12,Lazio,41.89277044,12.48366722,1370,96,1466,2986,4452,6,84,1807,497,6756,147078,114761,,,-2,-9,-11,17,63,15,84,3274
2020-02-25T18:00:00,ITA,13,Abruzzo,42.35122196,13.39843823,0,0,0,0,0,0,0,0,0,0,5,null,,,0,0,0,0,0,0,0,0
2020-02-26T18:00:00,ITA,13,Abruzzo,42.35122196,13.39843823,0,0,0,0,0,0,0,0,0,0,13,null,,,0,0,0,0,0,0,0,13
2020-02-27T18:00:00,ITA,13,Abruzzo,42.35122196,13.39843823,1,0,1,0,1,1,1,0,0,1,33,null,,,1,0,1,0,0,0,1,20
2020-02-28T18:00:00,ITA,13,Abruzzo,42.35122196,13.39843823,1,0,1,0,1,0,0,0,0,1,33,null,,,0,0,0,0,0,0,0,0
2020-02-29T17:00:00,ITA,13,Abruzzo,42.35122196,13.39843823,2,0,2,0,2,1,1,0,0,2,43,null,,,1,0,1,0,0,0,1,10
2020-03-01T17:00:00,ITA,13,Abruzzo,42.35122196,13.39843823,3,0,3,2,5,3,3,0,0,5,52,null,,,1,0,1,2,0,0,3,9
2020-03-02T18:00:00,ITA,13,Abruzzo,42.35122196,13.39843823,3,0,3,2,5,0,0,0,0,5,52,null,,,0,0,0,0,0,0,0,0
2020-03-03T18:00:00,ITA,13,Abruzzo,42.35122196,13.39843823,5,0,5,1,6,1,1,0,0,6,52,null,,,2,0,2,-1,0,0,1,0
2020-03-04T17:00:00,ITA,13,Abruzzo,42.35122196,13.39843823,7,0,7,0,7,1,1,0,0,7,85,null,,,2,0,2,-1,0,0,1,33
2020-03-05T17:00:00,ITA,13,Abruzzo,42.35122196,13.39843823,8,0,8,0,8,1,1,0,0,8,96,null,,,1,0,1,0,0,0,1,11
2020-03-06T17:00:00,ITA,13,Abruzzo,42.35122196,13.39843823,9,0,9,0,9,1,1,0,0,9,96,null,,,1,0,1,0,0,0,1,0
2020-03-07T18:00:00,ITA,13,Abruzzo,42.35122196,13.39843823,11,0,11,0,11,2,2,0,0,11,123,null,,,2,0,2,0,0,0,2,27
2020-03-08T18:00:00,ITA,13,Abruzzo,42.35122196,13.39843823,14,0,14,3,17,6,6,0,0,17,163,null,,,3,0,3,3,0,0,6,40
2020-03-09T18:00:00,ITA,13,Abruzzo,42.35122196,13.39843823,25,0,25,5,30,13,13,0,0,30,237,null,,,11,0,11,2,0,0,13,74
2020-03-10T18:00:00,ITA,13,Abruzzo,42.35122196,13.39843823,17,9,26,11,37,7,8,0,1,38,310,null,,,-8,9,1,6,0,1,8,73
2020-03-11T17:00:00,ITA,13,Abruzzo,42.35122196,13.39843823,17,9,26,11,37,0,0,0,1,38,310,null,nd-IT-0001,nd-EN-0001,0,0,0,0,0,0,0,0
2020-03-12T17:00:00,ITA,13,Abruzzo,42.35122196,13.39843823,47,12,59,19,78,41,46,4,2,84,867,null,,,30,3,33,8,4,1,46,557
2020-03-13T17:00:00,ITA,13,Abruzzo,42.35122196,13.39843823,42,14,56,27,83,5,5,4,2,89,958,null,,,-5,2,-3,8,0,0,5,91
2020-03-14T17:00:00,ITA,13,Abruzzo,42.35122196,13.39843823,51,14,65,41,106,23,23,4,2,112,1232,null,,,9,0,9,14,0,0,23,274
2020-03-15T17:00:00,ITA,13,Abruzzo,42.35122196,13.39843823,72,28,100,28,128,22,25,6,3,137,1419,null,,,21,14,35,-13,2,1,25,187
2020-03-16T17:00:00,ITA,13,Abruzzo,42.35122196,13.39843823,71,37,108,57,165,37,39,7,4,176,1533,null,,,-1,9,8,29,1,1,39,114
2020-03-17T17:00:00,ITA,13,Abruzzo,42.35122196,13.39843823,94,32,126,90,216,51,53,7,6,229,1688,null,,,23,-5,18,33,0,2,53,155
2020-03-18T17:00:00,ITA,13,Abruzzo,42.35122196,13.39843823,99,41,140,109,249,33,34,7,7,263,2054,null,,,5,9,14,19,0,1,34,366
2020-03-19T17:00:00,ITA,13,Abruzzo,42.35122196,13.39843823,181,47,228,138,366,117,122,8,11,385,2409,null,,,82,6,88,29,1,4,122,355
2020-03-20T17:00:00,ITA,13,Abruzzo,42.35122196,13.39843823,190,48,238,184,422,56,64,10,17,449,2695,null,,,9,1,10,46,2,6,64,286
2020-03-21T17:00:00,ITA,13,Abruzzo,42.35122196,13.39843823,185,44,229,265,494,72,80,13,22,529,3035,null,,,-5,-4,-9,81,3,5,80,340
2020-03-22T17:00:00,ITA,13,Abruzzo,42.35122196,13.39843823,218,49,267,272,539,45,58,15,33,587,3375,null,,,33,5,38,7,2,11,58,340
2020-03-23T17:00:00,ITA,13,Abruzzo,42.35122196,13.39843823,228,52,280,325,605,66,76,20,38,663,3674,null,,,10,3,13,53,5,5,76,299
2020-03-24T17:00:00,ITA,13,Abruzzo,42.35122196,13.39843823,234,57,291,331,622,17,26,21,46,689,4294,null,,,6,5,11,6,1,8,26,620
2020-03-25T17:00:00,ITA,13,Abruzzo,42.35122196,13.39843823,248,59,307,431,738,116,124,23,52,813,4982,null,,,14,2,16,100,2,6,124,688
2020-03-26T17:00:00,ITA,13,Abruzzo,42.35122196,13.39843823,280,64,344,516,860,122,133,23,63,946,5488,null,,,32,5,37,85,0,11,133,506
2020-03-27T17:00:00,ITA,13,Abruzzo,42.35122196,13.39843823,289,71,360,565,925,65,71,24,68,1017,6109,null,,,9,7,16,49,1,5,71,621
2020-03-28T17:00:00,ITA,13,Abruzzo,42.35122196,13.39843823,311,70,381,646,1027,102,116,30,76,1133,7003,null,,,22,-1,21,81,6,8,116,894
2020-03-29T17:00:00,ITA,13,Abruzzo,42.35122196,13.39843823,329,68,397,772,1169,142,160,36,88,1293,7730,null,,,18,-2,16,126,6,12,160,727
2020-03-30T17:00:00,ITA,13,Abruzzo,42.35122196,13.39843823,322,69,391,778,1169,0,52,74,102,1345,7948,null,,,-7,1,-6,6,38,14,52,218
2020-03-31T17:00:00,ITA,13,Abruzzo,42.35122196,13.39843823,335,73,408,783,1191,22,56,95,115,1401,8758,null,,,13,4,17,5,21,13,56,810
2020-04-01T17:00:00,ITA,13,Abruzzo,42.35122196,13.39843823,342,71,413,798,1211,20,35,102,123,1436,9610,null,,,7,-2,5,15,7,8,35,852
2020-04-02T17:00:00,ITA,13,Abruzzo,42.35122196,13.39843823,341,75,416,835,1251,40,61,113,133,1497,10647,null,,,-1,4,3,37,11,10,61,1037
2020-04-03T17:00:00,ITA,13,Abruzzo,42.35122196,13.39843823,361,76,437,864,1301,50,66,116,146,1563,11890,null,,,20,1,21,29,3,13,66,1243
2020-04-04T17:00:00,ITA,13,Abruzzo,42.35122196,13.39843823,354,71,425,931,1356,55,65,119,153,1628,12837,null,,,-7,-5,-12,67,3,7,65,947
2020-04-05T17:00:00,ITA,13,Abruzzo,42.35122196,13.39843823,347,67,414,1006,1420,64,75,125,158,1703,13598,null,,,-7,-4,-11,75,6,5,75,761
2020-04-06T17:00:00,ITA,13,Abruzzo,42.35122196,13.39843823,340,66,406,1019,1425,5,18,127,169,1721,14198,null,,,-7,-1,-8,13,2,11,18,600
2020-04-07T17:00:00,ITA,13,Abruzzo,42.35122196,13.39843823,337,67,404,1087,1491,66,78,136,172,1799,14904,null,,,-3,1,-2,68,9,3,78,706
2020-04-08T17:00:00,ITA,13,Abruzzo,42.35122196,13.39843823,331,62,393,1141,1534,43,60,146,179,1859,15846,null,,,-6,-5,-11,54,10,7,60,942
2020-04-09T17:00:00,ITA,13,Abruzzo,42.35122196,13.39843823,306,57,363,1203,1566,32,72,171,194,1931,16847,null,,,-25,-5,-30,62,25,15,72,1001
2020-04-10T17:00:00,ITA,13,Abruzzo,42.35122196,13.39843823,305,53,358,1277,1635,69,83,181,198,2014,18088,null,,,-1,-4,-5,74,10,4,83,1241
2020-04-11T17:00:00,ITA,13,Abruzzo,42.35122196,13.39843823,315,54,369,1355,1724,89,106,190,206,2120,19441,null,,,10,1,11,78,9,8,106,1353
2020-04-12T17:00:00,ITA,13,Abruzzo,42.35122196,13.39843823,346,54,400,1342,1742,18,40,206,212,2160,20594,null,,,31,0,31,-13,16,6,40,1153
2020-04-13T17:00:00,ITA,13,Abruzzo,42.35122196,13.39843823,351,54,405,1373,1778,36,53,211,224,2213,20667,null,,,5,0,5,31,5,12,53,73
2020-04-14T17:00:00,ITA,13,Abruzzo,42.35122196,13.39843823,345,52,397,1403,1800,22,32,213,232,2245,20935,null,,,-6,-2,-8,30,2,8,32,268
2020-04-15T17:00:00,ITA,13,Abruzzo,42.35122196,13.39843823,341,44,385,1425,1810,10,29,224,240,2274,22500,null,,,-4,-8,-12,22,11,8,29,1565
2020-04-16T17:00:00,ITA,13,Abruzzo,42.35122196,13.39843823,324,42,366,1484,1850,40,72,253,243,2346,23786,null,,,-17,-2,-19,59,29,3,72,1286
2020-04-17T17:00:00,ITA,13,Abruzzo,42.35122196,13.39843823,319,43,362,1580,1942,92,97,255,246,2443,25436,null,,,-5,1,-4,96,2,3,97,1650
2020-04-18T17:00:00,ITA,13,Abruzzo,42.35122196,13.39843823,321,41,362,1609,1971,29,44,263,253,2487,27016,null,,,2,-2,0,29,8,7,44,1580
2020-04-19T17:00:00,ITA,13,Abruzzo,42.35122196,13.39843823,317,40,357,1630,1987,16,34,276,258,2521,27791,22424,,,-4,-1,-5,21,13,5,34,775
2020-04-20T17:00:00,ITA,13,Abruzzo,42.35122196,13.39843823,320,38,358,1704,2062,75,91,287,263,2612,27942,22552,,,3,-2,1,74,11,5,91,151
2020-04-21T17:00:00,ITA,13,Abruzzo,42.35122196,13.39843823,318,35,353,1714,2067,5,55,329,271,2667,29906,23901,,,-2,-3,-5,10,42,8,55,1964
2020-04-22T17:00:00,ITA,13,Abruzzo,42.35122196,13.39843823,309,35,344,1764,2108,41,66,349,276,2733,30348,24317,,,-9,0,-9,50,20,5,66,442
2020-04-23T17:00:00,ITA,13,Abruzzo,42.35122196,13.39843823,322,31,353,1747,2100,-8,52,405,280,2785,31187,24751,,,13,-4,9,-17,56,4,52,839
2020-04-24T17:00:00,ITA,13,Abruzzo,42.35122196,13.39843823,327,28,355,1724,2079,-21,18,438,286,2803,32397,25397,,,5,-3,2,-23,33,6,18,1210
2020-04-25T17:00:00,ITA,13,Abruzzo,42.35122196,13.39843823,323,26,349,1712,2061,-18,29,478,293,2832,33624,25959,,,-4,-2,-6,-12,40,7,29,1227
2020-04-26T17:00:00,ITA,13,Abruzzo,42.35122196,13.39843823,324,24,348,1720,2068,7,27,496,295,2859,33820,26184,,,1,-2,-1,8,18,2,27,196
2020-04-27T17:00:00,ITA,13,Abruzzo,42.35122196,13.39843823,328,23,351,1679,2030,-38,15,545,299,2874,34176,26443,,,4,-1,3,-41,49,4,15,356
2020-04-28T17:00:00,ITA,13,Abruzzo,42.35122196,13.39843823,312,21,333,1657,1990,-40,25,599,310,2899,35356,27054,,,-16,-2,-18,-22,54,11,25,1180
2020-04-29T17:00:00,ITA,13,Abruzzo,42.35122196,13.39843823,309,19,328,1648,1976,-14,24,632,315,2923,36614,27703,,,-3,-2,-5,-9,33,5,24,1258
2020-04-30T17:00:00,ITA,13,Abruzzo,42.35122196,13.39843823,306,16,322,1593,1915,-61,7,695,320,2930,37996,28351,,,-3,-3,-6,-55,63,5,7,1382
2020-05-01T17:00:00,ITA,13,Abruzzo,42.35122196,13.39843823,297,16,313,1598,1911,-4,18,713,324,2948,39385,29024,,,-9,0,-9,5,18,4,18,1389
2020-05-02T17:00:00,ITA,13,Abruzzo,42.35122196,13.39843823,303,16,319,1560,1879,-32,16,758,327,2964,39916,29308,,,6,0,6,-38,45,3,16,531
2020-02-24T18:00:00,ITA,14,Molise,41.55774754,14.65916051,0,0,0,0,0,0,0,0,0,0,0,null,,,0,0,0,0,0,0,0,0
2020-02-25T18:00:00,ITA,14,Molise,41.55774754,14.65916051,0,0,0,0,0,0,0,0,0,0,0,null,,,0,0,0,0,0,0,0,0
2020-02-26T18:00:00,ITA,14,Molise,41.55774754,14.65916051,0,0,0,0,0,0,0,0,0,0,0,null,,,0,0,0,0,0,0,0,0
2020-02-27T18:00:00,ITA,14,Molise,41.55774754,14.65916051,0,0,0,0,0,0,0,0,0,0,0,null,,,0,0,0,0,0,0,0,0
2020-02-28T18:00:00,ITA,14,Molise,41.55774754,14.65916051,0,0,0,0,0,0,0,0,0,0,0,null,,,0,0,0,0,0,0,0,0
2020-02-29T17:00:00,ITA,14,Molise,41.55774754,14.65916051,0,0,0,0,0,0,0,0,0,0,0,null,,,0,0,0,0,0,0,0,0
2020-03-01T17:00:00,ITA,14,Molise,41.55774754,14.65916051,0,0,0,0,0,0,0,0,0,0,6,null,,,0,0,0,0,0,0,0,6
2020-03-02T18:00:00,ITA,14,Molise,41.55774754,14.65916051,0,0,0,0,0,0,0,0,0,0,13,null,,,0,0,0,0,0,0,0,7
2020-03-03T18:00:00,ITA,14,Molise,41.55774754,14.65916051,3,0,3,0,3,3,3,0,0,3,13,null,,,3,0,3,0,0,0,3,0
2020-03-04T17:00:00,ITA,14,Molise,41.55774754,14.65916051,3,0,3,0,3,0,0,0,0,3,19,null,,,0,0,0,0,0,0,0,6
2020-03-05T17:00:00,ITA,14,Molise,41.55774754,14.65916051,4,0,4,3,7,4,4,0,0,7,24,null,,,1,0,1,3,0,0,4,5
2020-03-06T17:00:00,ITA,14,Molise,41.55774754,14.65916051,3,2,5,7,12,5,5,0,0,12,104,null,,,-1,2,1,4,0,0,5,80
2020-03-07T18:00:00,ITA,14,Molise,41.55774754,14.65916051,3,2,5,9,14,2,2,0,0,14,112,null,,,0,0,0,2,0,0,2,8
2020-03-08T18:00:00,ITA,14,Molise,41.55774754,14.65916051,4,2,6,8,14,0,0,0,0,14,116,null,,,1,0,1,-1,0,0,0,4
2020-03-09T18:00:00,ITA,14,Molise,41.55774754,14.65916051,4,2,6,8,14,0,0,0,0,14,212,null,,,0,0,0,0,0,0,0,96
2020-03-10T18:00:00,ITA,14,Molise,41.55774754,14.65916051,3,3,6,9,15,1,1,0,0,15,225,null,,,-1,1,0,1,0,0,1,13
2020-03-11T17:00:00,ITA,14,Molise,41.55774754,14.65916051,4,3,7,9,16,1,1,0,0,16,233,null,,,1,0,1,0,0,0,1,8
2020-03-12T17:00:00,ITA,14,Molise,41.55774754,14.65916051,4,3,7,9,16,0,0,0,0,16,238,null,,,0,0,0,0,0,0,0,5
2020-03-13T17:00:00,ITA,14,Molise,41.55774754,14.65916051,5,3,8,9,17,1,1,0,0,17,243,null,,,1,0,1,0,0,0,1,5
2020-03-14T17:00:00,ITA,14,Molise,41.55774754,14.65916051,5,3,8,9,17,0,0,0,0,17,247,null,,,0,0,0,0,0,0,0,4
2020-03-15T17:00:00,ITA,14,Molise,41.55774754,14.65916051,3,4,7,10,17,0,0,0,0,17,248,null,,,-2,1,-1,1,0,0,0,1
2020-03-16T17:00:00,ITA,14,Molise,41.55774754,14.65916051,3,5,8,7,15,-2,4,5,1,21,253,null,,,0,1,1,-3,5,1,4,5
2020-03-17T17:00:00,ITA,14,Molise,41.55774754,14.65916051,7,5,12,7,19,4,4,5,1,25,301,null,,,4,0,4,0,0,0,4,48
2020-03-18T17:00:00,ITA,14,Molise,41.55774754,14.65916051,7,6,13,8,21,2,3,6,1,28,361,null,,,0,1,1,1,1,0,3,60
2020-03-19T17:00:00,ITA,14,Molise,41.55774754,14.65916051,19,6,25,13,38,17,18,6,2,46,426,null,,,12,0,12,5,0,1,18,65
2020-03-20T17:00:00,ITA,14,Molise,41.55774754,14.65916051,20,6,26,13,39,1,4,6,5,50,426,null,,,1,0,1,0,0,3,4,0
2020-03-21T17:00:00,ITA,14,Molise,41.55774754,14.65916051,21,6,27,20,47,8,11,7,7,61,449,null,,,1,0,1,7,1,2,11,23
2020-03-22T17:00:00,ITA,14,Molise,41.55774754,14.65916051,24,7,31,21,52,5,5,7,7,66,532,null,,,3,1,4,1,0,0,5,83
2020-03-23T17:00:00,ITA,14,Molise,41.55774754,14.65916051,25,7,32,18,50,-2,1,10,7,67,532,null,,,1,0,1,-3,3,0,1,0
2020-03-24T17:00:00,ITA,14,Molise,41.55774754,14.65916051,27,7,34,21,55,5,6,10,8,73,572,null,,,2,0,2,3,0,1,6,40
2020-03-25T17:00:00,ITA,14,Molise,41.55774754,14.65916051,26,7,33,20,53,-2,0,12,8,73,580,null,,,-1,0,-1,-1,2,0,0,8
2020-03-26T17:00:00,ITA,14,Molise,41.55774754,14.65916051,27,8,35,46,81,28,30,14,8,103,670,null,,,1,1,2,26,2,0,30,90
2020-03-27T17:00:00,ITA,14,Molise,41.55774754,14.65916051,26,9,35,51,86,5,6,14,9,109,710,null,,,-1,1,0,5,0,1,6,40
2020-03-28T17:00:00,ITA,14,Molise,41.55774754,14.65916051,26,9,35,63,98,12,14,16,9,123,807,null,,,0,0,0,12,2,0,14,97
2020-03-29T17:00:00,ITA,14,Molise,41.55774754,14.65916051,25,9,34,66,100,2,4,18,9,127,918,null,,,-1,0,-1,3,2,0,4,111
2020-03-30T17:00:00,ITA,14,Molise,41.55774754,14.65916051,27,8,35,72,107,7,7,18,9,134,955,null,,,2,-1,1,6,0,0,7,37
2020-03-31T17:00:00,ITA,14,Molise,41.55774754,14.65916051,29,8,37,80,117,10,10,18,9,144,1049,null,,,2,0,2,8,0,0,10,94
2020-04-01T17:00:00,ITA,14,Molise,41.55774754,14.65916051,32,8,40,91,131,14,16,19,10,160,1157,null,,,3,0,3,11,1,1,16,108
2020-04-02T17:00:00,ITA,14,Molise,41.55774754,14.65916051,30,8,38,95,133,2,5,21,11,165,1229,null,,,-2,0,-2,4,2,1,5,72
2020-04-03T17:00:00,ITA,14,Molise,41.55774754,14.65916051,31,8,39,105,144,11,11,21,11,176,1378,null,,,1,0,1,10,0,0,11,149
2020-04-04T17:00:00,ITA,14,Molise,41.55774754,14.65916051,31,6,37,134,171,27,30,24,11,206,1504,null,,,0,-2,-2,29,3,0,30,126
2020-04-05T17:00:00,ITA,14,Molise,41.55774754,14.65916051,33,6,39,148,187,16,18,24,13,224,1504,null,,,2,0,2,14,0,2,18,0
2020-04-06T17:00:00,ITA,14,Molise,41.55774754,14.65916051,34,5,39,148,187,0,0,24,13,224,1546,null,,,1,-1,0,0,0,0,0,42
2020-04-07T17:00:00,ITA,14,Molise,41.55774754,14.65916051,35,5,40,145,185,-2,0,26,13,224,1581,null,,,1,0,1,-3,2,0,0,35
2020-04-08T17:00:00,ITA,14,Molise,41.55774754,14.65916051,30,4,34,147,181,-4,2,32,13,226,2002,null,,,-5,-1,-6,2,6,0,2,421
2020-04-09T17:00:00,ITA,14,Molise,41.55774754,14.65916051,30,4,34,155,189,8,8,32,13,234,2069,null,,,0,0,0,8,0,0,8,67
2020-04-10T17:00:00,ITA,14,Molise,41.55774754,14.65916051,28,4,32,161,193,4,9,37,13,243,2069,null,pd-IT-0010,pd-EN-0010,-2,0,-2,6,5,0,9,0
2020-04-11T17:00:00,ITA,14,Molise,41.55774754,14.65916051,28,4,32,161,193,0,3,39,14,246,2201,null,,,0,0,0,0,2,1,3,132
2020-04-12T17:00:00,ITA,14,Molise,41.55774754,14.65916051,27,4,31,171,202,9,11,40,15,257,2471,null,,,-1,0,-1,10,1,1,11,270
2020-04-13T17:00:00,ITA,14,Molise,41.55774754,14.65916051,28,4,32,170,202,0,0,40,15,257,2522,null,,,1,0,1,-1,0,0,0,51
2020-04-14T17:00:00,ITA,14,Molise,41.55774754,14.65916051,26,4,30,170,200,-2,0,42,15,257,2522,null,,,-2,0,-2,0,2,0,0,0
2020-04-15T17:00:00,ITA,14,Molise,41.55774754,14.65916051,27,4,31,175,206,6,6,42,15,263,2855,null,,,1,0,1,5,0,0,6,333
2020-04-16T17:00:00,ITA,14,Molise,41.55774754,14.65916051,25,4,29,174,203,-3,0,44,16,263,2967,null,,,-2,0,-2,-1,2,1,0,112
2020-04-17T17:00:00,ITA,14,Molise,41.55774754,14.65916051,26,4,30,178,208,5,6,45,16,269,3082,null,,,1,0,1,4,1,0,6,115
2020-04-18T17:00:00,ITA,14,Molise,41.55774754,14.65916051,27,4,31,178,209,1,0,44,16,269,3082,null,,,1,0,1,0,-1,0,0,0
2020-04-19T17:00:00,ITA,14,Molise,41.55774754,14.65916051,27,4,31,184,215,6,10,47,17,279,3584,3482,,,0,0,0,6,3,1,10,502
2020-04-20T17:00:00,ITA,14,Molise,41.55774754,14.65916051,27,2,29,184,213,-2,2,50,18,281,3783,3683,,,0,-2,-2,0,3,1,2,199
2020-04-21T17:00:00,ITA,14,Molise,41.55774754,14.65916051,27,2,29,184,213,0,1,51,18,282,4124,4015,,,0,0,0,0,1,0,1,341
2020-04-22T17:00:00,ITA,14,Molise,41.55774754,14.65916051,21,2,23,182,205,-8,2,60,19,284,4425,4252,,,-6,0,-6,-2,9,1,2,301
2020-04-23T17:00:00,ITA,14,Molise,41.55774754,14.65916051,19,1,20,178,198,-7,0,66,20,284,4564,4478,,,-2,-1,-3,-4,6,1,0,139
2020-04-24T17:00:00,ITA,14,Molise,41.55774754,14.65916051,19,1,20,180,200,2,3,67,20,287,4805,4718,,,0,0,0,2,1,0,3,241
2020-04-25T17:00:00,ITA,14,Molise,41.55774754,14.65916051,19,1,20,178,198,-2,5,73,21,292,5191,5089,,,0,0,0,-2,6,1,5,386
2020-04-26T17:00:00,ITA,14,Molise,41.55774754,14.65916051,20,1,21,179,200,2,4,75,21,296,5567,5334,,,1,0,1,1,2,0,4,376
2020-04-27T17:00:00,ITA,14,Molise,41.55774754,14.65916051,20,1,21,179,200,0,0,75,21,296,5656,5423,,,0,0,0,0,0,0,0,89
2020-04-28T17:00:00,ITA,14,Molise,41.55774754,14.65916051,18,1,19,176,195,-5,1,81,21,297,5776,5538,,,-2,0,-2,-3,6,0,1,120
2020-04-29T17:00:00,ITA,14,Molise,41.55774754,14.65916051,17,1,18,175,193,-2,0,83,21,297,5910,5857,,,-1,0,-1,-1,2,0,0,134
2020-04-30T17:00:00,ITA,14,Molise,41.55774754,14.65916051,17,1,18,172,190,-3,1,87,21,298,6446,6228,,,0,0,0,-3,4,0,1,536
2020-05-01T17:00:00,ITA,14,Molise,41.55774754,14.65916051,17,1,18,172,190,0,2,89,21,300,6463,6450,,,0,0,0,0,2,0,2,17
2020-05-02T17:00:00,ITA,14,Molise,41.55774754,14.65916051,9,1,10,172,182,-8,1,98,21,301,7075,6808,,,-8,0,-8,0,9,0,1,612
2020-02-24T18:00:00,ITA,15,Campania,40.83956555,14.25084984,0,0,0,0,0,0,0,0,0,0,10,null,,,0,0,0,0,0,0,0,0
2020-02-25T18:00:00,ITA,15,Campania,40.83956555,14.25084984,0,0,0,0,0,0,0,0,0,0,10,null,,,0,0,0,0,0,0,0,10
2020-02-26T18:00:00,ITA,15,Campania,40.83956555,14.25084984,0,0,0,0,0,0,0,0,0,0,10,null,,,0,0,0,0,0,0,0,0
2020-02-27T18:00:00,ITA,15,Campania,40.83956555,14.25084984,2,0,2,1,3,3,3,0,0,3,10,null,,,2,0,2,1,0,0,3,0
2020-02-28T18:00:00,ITA,15,Campania,40.83956555,14.25084984,2,0,2,2,4,1,1,0,0,4,213,null,,,0,0,0,1,0,0,1,203
2020-02-29T17:00:00,ITA,15,Campania,40.83956555,14.25084984,3,0,3,10,13,9,9,0,0,13,373,null,,,1,0,1,8,0,0,9,160
2020-03-01T17:00:00,ITA,15,Campania,40.83956555,14.25084984,4,0,4,13,17,4,4,0,0,17,373,null,,,1,0,1,3,0,0,4,0
2020-03-02T18:00:00,ITA,15,Campania,40.83956555,14.25084984,4,0,4,13,17,0,0,0,0,17,373,null,,,0,0,0,0,0,0,0,0
2020-03-03T18:00:00,ITA,15,Campania,40.83956555,14.25084984,11,0,11,19,30,13,13,0,0,30,405,null,,,7,0,7,6,0,0,13,32
2020-03-04T17:00:00,ITA,15,Campania,40.83956555,14.25084984,11,0,11,20,31,1,1,0,0,31,429,null,,,0,0,0,1,0,0,1,24
2020-03-05T17:00:00,ITA,15,Campania,40.83956555,14.25084984,12,0,12,33,45,14,14,0,0,45,471,null,,,1,0,1,13,0,0,14,42
2020-03-06T17:00:00,ITA,15,Campania,40.83956555,14.25084984,12,0,12,45,57,12,12,0,0,57,471,null,,,0,0,0,12,0,0,12,0
2020-03-07T18:00:00,ITA,15,Campania,40.83956555,14.25084984,16,0,16,45,61,4,4,0,0,61,612,null,,,4,0,4,0,0,0,4,141
2020-03-08T18:00:00,ITA,15,Campania,40.83956555,14.25084984,30,7,37,63,100,39,40,1,0,101,980,null,,,14,7,21,18,1,0,40,368
2020-03-09T18:00:00,ITA,15,Campania,40.83956555,14.25084984,42,8,50,69,119,19,19,1,0,120,980,null,,,12,1,13,6,0,0,19,0
2020-03-10T18:00:00,ITA,15,Campania,40.83956555,14.25084984,33,8,41,85,126,7,7,1,0,127,1141,null,,,-9,0,-9,16,0,0,7,161
2020-03-11T17:00:00,ITA,15,Campania,40.83956555,14.25084984,56,11,67,82,149,23,27,4,1,154,1375,null,,,23,3,26,-3,3,1,27,234
2020-03-12T17:00:00,ITA,15,Campania,40.83956555,14.25084984,56,11,67,107,174,25,25,4,1,179,1551,null,,,0,0,0,25,0,0,25,176
2020-03-13T17:00:00,ITA,15,Campania,40.83956555,14.25084984,60,19,79,134,213,39,41,5,2,220,1671,null,,,4,8,12,27,1,1,41,120
2020-03-14T17:00:00,ITA,15,Campania,40.83956555,14.25084984,72,17,89,154,243,30,52,23,6,272,1936,null,,,12,-2,10,20,18,4,52,265
2020-03-15T17:00:00,ITA,15,Campania,40.83956555,14.25084984,73,22,95,201,296,53,61,28,9,333,2213,null,,,1,5,6,47,5,3,61,277
2020-03-16T17:00:00,ITA,15,Campania,40.83956555,14.25084984,103,22,125,238,363,67,67,28,9,400,2517,null,,,30,0,30,37,0,0,67,304
2020-03-17T17:00:00,ITA,15,Campania,40.83956555,14.25084984,127,24,151,272,423,60,60,28,9,460,2685,null,,,24,2,26,34,0,0,60,168
2020-03-18T17:00:00,ITA,15,Campania,40.83956555,14.25084984,127,24,151,272,423,0,0,28,9,460,2685,null,nd-IT-0013,nd-EN-0013,0,0,0,0,0,0,0,0
2020-03-19T17:00:00,ITA,15,Campania,40.83956555,14.25084984,213,36,249,356,605,182,192,30,17,652,3544,null,,,86,12,98,84,2,8,192,859
2020-03-20T17:00:00,ITA,15,Campania,40.83956555,14.25084984,130,41,171,531,702,97,97,30,17,749,3845,null,,,-83,5,-78,175,0,0,97,301
2020-03-21T17:00:00,ITA,15,Campania,40.83956555,14.25084984,233,87,320,473,793,91,95,29,22,844,4448,null,,,103,46,149,-58,-1,5,95,603
2020-03-22T17:00:00,ITA,15,Campania,40.83956555,14.25084984,243,99,342,524,866,73,92,41,29,936,4943,null,,,10,12,22,51,12,7,92,495
2020-03-23T17:00:00,ITA,15,Campania,40.83956555,14.25084984,266,110,376,553,929,63,90,48,49,1026,5813,null,,,23,11,34,29,7,20,90,870
2020-03-24T17:00:00,ITA,15,Campania,40.83956555,14.25084984,345,181,526,466,992,63,75,53,56,1101,6297,null,,,79,71,150,-87,5,7,75,484
2020-03-25T17:00:00,ITA,15,Campania,40.83956555,14.25084984,318,123,441,631,1072,80,98,53,74,1199,6972,null,,,-27,-58,-85,165,0,18,98,675
2020-03-26T17:00:00,ITA,15,Campania,40.83956555,14.25084984,448,114,562,607,1169,97,111,58,83,1310,8346,null,,,130,-9,121,-24,5,9,111,1374
2020-03-27T17:00:00,ITA,15,Campania,40.83956555,14.25084984,456,113,569,723,1292,123,144,64,98,1454,9613,null,,,8,-1,7,116,6,15,144,1267
2020-03-28T17:00:00,ITA,15,Campania,40.83956555,14.25084984,463,132,595,812,1407,115,138,76,109,1592,10616,null,,,7,19,26,89,12,11,138,1003
2020-03-29T17:00:00,ITA,15,Campania,40.83956555,14.25084984,476,135,611,945,1556,149,167,86,117,1759,11805,null,,,13,3,16,133,10,8,167,1189
2020-03-30T17:00:00,ITA,15,Campania,40.83956555,14.25084984,468,126,594,1145,1739,183,193,88,125,1952,12969,null,,,-8,-9,-17,200,2,8,193,1164
2020-03-31T17:00:00,ITA,15,Campania,40.83956555,14.25084984,501,133,634,1237,1871,132,140,88,133,2092,14403,null,,,33,7,40,92,0,8,140,1434
2020-04-01T17:00:00,ITA,15,Campania,40.83956555,14.25084984,478,129,607,1369,1976,105,139,107,148,2231,15728,null,,,-23,-4,-27,132,19,15,139,1325
2020-04-02T17:00:00,ITA,15,Campania,40.83956555,14.25084984,503,120,623,1517,2140,164,225,149,167,2456,17404,null,,,25,-9,16,148,42,19,225,1676
2020-04-03T17:00:00,ITA,15,Campania,40.83956555,14.25084984,532,115,647,1705,2352,212,221,144,181,2677,19237,null,,,29,-5,24,188,-5,14,221,1833
2020-04-04T17:00:00,ITA,15,Campania,40.83956555,14.25084984,567,114,681,1815,2496,144,151,146,186,2828,21534,null,,,35,-1,34,110,2,5,151,2297
2020-04-05T17:00:00,ITA,15,Campania,40.83956555,14.25084984,609,108,717,1904,2621,125,132,150,189,2960,23139,null,,,42,-6,36,89,4,3,132,1605
2020-04-06T17:00:00,ITA,15,Campania,40.83956555,14.25084984,610,101,711,1987,2698,77,98,156,204,3058,24526,null,,,1,-7,-6,83,6,15,98,1387
2020-04-07T17:00:00,ITA,15,Campania,40.83956555,14.25084984,603,103,706,2059,2765,67,90,167,216,3148,25779,null,,,-7,2,-5,72,11,12,90,1253
2020-04-08T17:00:00,ITA,15,Campania,40.83956555,14.25084984,608,97,705,2154,2859,94,120,188,221,3268,27784,null,,,5,-6,-1,95,21,5,120,2005
2020-04-09T17:00:00,ITA,15,Campania,40.83956555,14.25084984,604,94,698,2175,2873,14,76,244,227,3344,29664,null,,,-4,-3,-7,21,56,6,76,1880
2020-04-10T17:00:00,ITA,15,Campania,40.83956555,14.25084984,600,90,690,2273,2963,90,98,248,231,3442,31745,null,,,-4,-4,-8,98,4,4,98,2081
2020-04-11T17:00:00,ITA,15,Campania,40.83956555,14.25084984,582,85,667,2335,3002,39,75,277,238,3517,33781,null,,,-18,-5,-23,62,29,7,75,2036
2020-04-12T17:00:00,ITA,15,Campania,40.83956555,14.25084984,526,82,608,2449,3057,55,87,305,242,3604,35448,null,,,-56,-3,-59,114,28,4,87,1667
2020-04-13T17:00:00,ITA,15,Campania,40.83956555,14.25084984,606,80,686,2376,3062,5,66,360,248,3670,36770,null,,,80,-2,78,-73,55,6,66,1322
2020-04-14T17:00:00,ITA,15,Campania,40.83956555,14.25084984,618,82,700,2394,3094,32,99,415,260,3769,38094,null,,,12,2,14,18,55,12,99,1324
2020-04-15T17:00:00,ITA,15,Campania,40.83956555,14.25084984,607,86,693,2394,3087,-7,38,442,278,3807,39534,null,,,-11,4,-7,0,27,18,38,1440
2020-04-16T17:00:00,ITA,15,Campania,40.83956555,14.25084984,618,76,694,2424,3118,31,80,483,286,3887,41296,null,,,11,-10,1,30,41,8,80,1762
2020-04-17T17:00:00,ITA,15,Campania,40.83956555,14.25084984,622,76,698,2329,3027,-91,64,631,293,3951,43697,null,,,4,0,4,-95,148,7,64,2401
2020-04-18T17:00:00,ITA,15,Campania,40.83956555,14.25084984,605,76,681,2364,3045,18,37,643,300,3988,46294,null,,,-17,0,-17,35,12,7,37,2597
2020-04-19T17:00:00,ITA,15,Campania,40.83956555,14.25084984,590,61,651,2371,3022,-23,41,703,304,4029,48187,34994,,,-15,-15,-30,7,60,4,41,1893
2020-04-20T17:00:00,ITA,15,Campania,40.83956555,14.25084984,586,61,647,2372,3019,-3,45,746,309,4074,51090,36153,,,-4,0,-4,1,43,5,45,2903
2020-04-21T17:00:00,ITA,15,Campania,40.83956555,14.25084984,532,58,590,2356,2946,-73,61,872,317,4135,53548,37505,,,-54,-3,-57,-16,126,8,61,2458
2020-04-22T17:00:00,ITA,15,Campania,40.83956555,14.25084984,523,53,576,2422,2998,52,50,860,327,4185,55701,38679,,,-9,-5,-14,66,-12,10,50,2153
2020-04-23T17:00:00,ITA,15,Campania,40.83956555,14.25084984,539,47,586,2392,2978,-20,53,928,332,4238,58324,38679,pd-IT-0014,pd-EN-0014,16,-6,10,-30,68,5,53,2623
2020-04-24T17:00:00,ITA,15,Campania,40.83956555,14.25084984,524,44,568,2375,2943,-35,44,1003,336,4282,61331,40053,,,-15,-3,-18,-17,75,4,44,3007
2020-04-25T17:00:00,ITA,15,Campania,40.83956555,14.25084984,543,55,598,2337,2935,-8,17,1023,341,4299,64521,41399,,,19,11,30,-38,20,5,17,3190
2020-04-26T17:00:00,ITA,15,Campania,40.83956555,14.25084984,536,45,581,2343,2924,-11,32,1062,345,4331,67218,42279,,,-7,-10,-17,6,39,4,32,2697
2020-04-27T17:00:00,ITA,15,Campania,40.83956555,14.25084984,541,37,578,2299,2877,-47,18,1120,352,4349,68727,42463,,,5,-8,-3,-44,58,7,18,1509
2020-04-28T17:00:00,ITA,15,Campania,40.83956555,14.25084984,544,33,577,2225,2802,-75,31,1220,358,4380,70566,42690,,,3,-4,-1,-74,100,6,31,1839
2020-04-29T17:00:00,ITA,15,Campania,40.83956555,14.25084984,518,31,549,2233,2782,-20,30,1269,359,4410,73094,43449,,,-26,-2,-28,8,49,1,30,2528
2020-04-30T17:00:00,ITA,15,Campania,40.83956555,14.25084984,484,29,513,2260,2773,-9,13,1291,359,4423,76108,44233,,,-34,-2,-36,27,22,0,13,3014
2020-05-01T17:00:00,ITA,15,Campania,40.83956555,14.25084984,478,29,507,2246,2753,-20,21,1332,359,4444,79940,44975,,,-6,0,-6,-14,41,0,21,3832
2020-05-02T17:00:00,ITA,15,Campania,40.83956555,14.25084984,470,27,497,2224,2721,-32,15,1376,362,4459,83592,45955,,,-8,-2,-10,-22,44,3,15,3652
2020-02-24T18:00:00,ITA,16,Puglia,41.12559576,16.86736689,0,0,0,0,0,0,0,0,0,0,0,null,,,0,0,0,0,0,0,0,0
2020-02-25T18:00:00,ITA,16,Puglia,41.12559576,16.86736689,0,0,0,0,0,0,0,0,0,0,0,null,,,0,0,0,0,0,0,0,0
2020-02-26T18:00:00,ITA,16,Puglia,41.12559576,16.86736689,0,0,0,0,0,0,0,0,0,0,0,null,,,0,0,0,0,0,0,0,0
2020-02-27T18:00:00,ITA,16,Puglia,41.12559576,16.86736689,1,0,1,0,1,1,1,0,0,1,0,null,,,1,0,1,0,0,0,1,0
2020-02-28T18:00:00,ITA,16,Puglia,41.12559576,16.86736689,1,0,1,2,3,2,2,0,0,3,242,null,,,0,0,0,2,0,0,2,242
2020-02-29T17:00:00,ITA,16,Puglia,41.12559576,16.86736689,1,0,1,2,3,0,0,0,0,3,252,null,,,0,0,0,0,0,0,0,10
2020-03-01T17:00:00,ITA,16,Puglia,41.12559576,16.86736689,1,0,1,2,3,0,0,0,0,3,262,null,,,0,0,0,0,0,0,0,10
2020-03-02T18:00:00,ITA,16,Puglia,41.12559576,16.86736689,2,0,2,2,4,1,1,0,0,4,278,null,,,1,0,1,0,0,0,1,16
2020-03-03T18:00:00,ITA,16,Puglia,41.12559576,16.86736689,2,0,2,4,6,2,2,0,0,6,298,null,,,0,0,0,2,0,0,2,20
2020-03-04T17:00:00,ITA,16,Puglia,41.12559576,16.86736689,4,0,4,3,7,1,3,1,1,9,322,null,,,2,0,2,-1,1,1,3,24
2020-03-05T17:00:00,ITA,16,Puglia,41.12559576,16.86736689,5,1,6,6,12,5,5,1,1,14,359,null,,,1,1,2,3,0,0,5,37
2020-03-06T17:00:00,ITA,16,Puglia,41.12559576,16.86736689,5,1,6,9,15,3,3,1,1,17,395,null,,,0,0,0,3,0,0,3,36
2020-03-07T18:00:00,ITA,16,Puglia,41.12559576,16.86736689,9,2,11,12,23,8,9,1,2,26,395,null,,,4,1,5,3,0,1,9,0
2020-03-08T18:00:00,ITA,16,Puglia,41.12559576,16.86736689,17,3,20,16,36,13,14,1,3,40,627,null,,,8,1,9,4,0,1,14,232
2020-03-09T18:00:00,ITA,16,Puglia,41.12559576,16.86736689,20,6,26,20,46,10,10,1,3,50,685,null,,,3,3,6,4,0,0,10,58
2020-03-10T18:00:00,ITA,16,Puglia,41.12559576,16.86736689,28,6,34,21,55,9,9,1,3,59,747,null,,,8,0,8,1,0,0,9,62
2020-03-11T17:00:00,ITA,16,Puglia,41.12559576,16.86736689,38,4,42,29,71,16,18,1,5,77,909,null,,,10,-2,8,8,0,2,18,162
2020-03-12T17:00:00,ITA,16,Puglia,41.12559576,16.86736689,58,2,60,38,98,27,27,1,5,104,1269,null,,,20,-2,18,9,0,0,27,360
2020-03-13T17:00:00,ITA,16,Puglia,41.12559576,16.86736689,77,2,79,42,121,23,25,3,5,129,1449,null,,,19,0,19,4,2,0,25,180
2020-03-14T17:00:00,ITA,16,Puglia,41.12559576,16.86736689,91,6,97,59,156,35,37,2,8,166,1681,null,,,14,4,18,17,-1,3,37,232
2020-03-15T17:00:00,ITA,16,Puglia,41.12559576,16.86736689,116,6,122,90,212,56,64,2,16,230,2017,null,,,25,0,25,31,0,8,64,336
2020-03-16T17:00:00,ITA,16,Puglia,41.12559576,16.86736689,116,6,122,90,212,0,0,2,16,230,2017,null,nd-IT-0005,nd-EN-0005,0,0,0,0,0,0,0,0
2020-03-17T17:00:00,ITA,16,Puglia,41.12559576,16.86736689,155,14,169,151,320,108,110,2,18,340,3077,null,,,39,8,47,61,0,2,110,1060
2020-03-18T17:00:00,ITA,16,Puglia,41.12559576,16.86736689,156,30,186,176,362,42,43,2,19,383,3433,null,,,1,16,17,25,0,1,43,356
2020-03-19T17:00:00,ITA,16,Puglia,41.12559576,16.86736689,173,31,204,245,449,87,95,4,25,478,4046,null,,,17,1,18,69,2,6,95,613
2020-03-20T17:00:00,ITA,16,Puglia,41.12559576,16.86736689,191,31,222,329,551,102,103,4,26,581,4789,null,,,18,0,18,84,0,1,103,743
2020-03-21T17:00:00,ITA,16,Puglia,41.12559576,16.86736689,209,33,242,400,642,91,94,4,29,675,5617,null,,,18,2,20,71,0,3,94,828
2020-03-22T17:00:00,ITA,16,Puglia,41.12559576,16.86736689,252,37,289,459,748,106,111,7,31,786,6160,null,,,43,4,47,59,3,2,111,543
2020-03-23T17:00:00,ITA,16,Puglia,41.12559576,16.86736689,285,45,330,532,862,114,120,7,37,906,6761,null,,,33,8,41,73,0,6,120,601
2020-03-24T17:00:00,ITA,16,Puglia,41.12559576,16.86736689,317,57,374,566,940,78,99,21,44,1005,7345,null,,,32,12,44,34,14,7,99,584
2020-03-25T17:00:00,ITA,16,Puglia,41.12559576,16.86736689,349,64,413,610,1023,83,88,22,48,1093,8223,null,,,32,7,39,44,1,4,88,878
2020-03-26T17:00:00,ITA,16,Puglia,41.12559576,16.86736689,480,76,556,539,1095,72,89,22,65,1182,9191,null,,,131,12,143,-71,0,17,89,968
2020-03-27T17:00:00,ITA,16,Puglia,41.12559576,16.86736689,530,82,612,624,1236,141,152,29,69,1334,10233,null,,,50,6,56,85,7,4,152,1042
2020-03-28T17:00:00,ITA,16,Puglia,41.12559576,16.86736689,563,98,661,697,1358,122,124,29,71,1458,11500,null,,,33,16,49,73,0,2,124,1267
2020-03-29T17:00:00,ITA,16,Puglia,41.12559576,16.86736689,559,99,658,774,1432,74,91,31,86,1549,12361,null,,,-4,1,-3,77,2,15,91,861
2020-03-30T17:00:00,ITA,16,Puglia,41.12559576,16.86736689,590,106,696,889,1585,153,163,36,91,1712,13117,null,,,31,7,38,115,5,5,163,756
2020-03-31T17:00:00,ITA,16,Puglia,41.12559576,16.86736689,609,105,714,940,1654,69,91,39,110,1803,14073,null,,,19,-1,18,51,3,19,91,956
2020-04-01T17:00:00,ITA,16,Puglia,41.12559576,16.86736689,637,107,744,1012,1756,102,143,61,129,1946,15209,null,,,28,2,30,72,22,19,143,1136
2020-04-02T17:00:00,ITA,16,Puglia,41.12559576,16.86736689,645,118,763,1101,1864,108,131,69,144,2077,16554,null,,,8,11,19,89,8,15,131,1345
2020-04-03T17:00:00,ITA,16,Puglia,41.12559576,16.86736689,648,123,771,1178,1949,85,105,69,164,2182,17924,null,,,3,5,8,77,0,20,105,1370
2020-04-04T17:00:00,ITA,16,Puglia,41.12559576,16.86736689,627,153,780,1193,1973,24,58,94,173,2240,18977,null,,,-21,30,9,15,25,9,58,1053
2020-04-05T17:00:00,ITA,16,Puglia,41.12559576,16.86736689,574,159,733,1289,2022,49,77,113,182,2317,20080,null,,,-53,6,-47,96,19,9,77,1103
2020-04-06T17:00:00,ITA,16,Puglia,41.12559576,16.86736689,625,97,722,1393,2115,93,127,134,195,2444,22059,null,,,51,-62,-11,104,21,13,127,1979
2020-04-07T17:00:00,ITA,16,Puglia,41.12559576,16.86736689,615,93,708,1429,2137,22,70,168,209,2514,23149,null,,,-10,-4,-14,36,34,14,70,1090
2020-04-08T17:00:00,ITA,16,Puglia,41.12559576,16.86736689,639,90,729,1509,2238,101,120,177,219,2634,24493,null,,,24,-3,21,80,9,10,120,1344
2020-04-09T17:00:00,ITA,16,Puglia,41.12559576,16.86736689,630,86,716,1585,2301,63,82,190,225,2716,26088,null,,,-9,-4,-13,76,13,6,82,1595
2020-04-10T17:00:00,ITA,16,Puglia,41.12559576,16.86736689,631,80,711,1625,2336,35,93,235,238,2809,27812,null,,,1,-6,-5,40,45,13,93,1724
2020-04-11T17:00:00,ITA,16,Puglia,41.12559576,16.86736689,627,73,700,1702,2402,66,95,249,253,2904,29463,null,,,-4,-7,-11,77,14,15,95,1651
2020-04-12T17:00:00,ITA,16,Puglia,41.12559576,16.86736689,609,71,680,1772,2452,50,85,277,260,2989,30973,null,,,-18,-2,-20,70,28,7,85,1510
2020-04-13T17:00:00,ITA,16,Puglia,41.12559576,16.86736689,600,71,671,1841,2512,60,76,286,267,3065,31922,null,,,-9,0,-9,69,9,7,76,949
2020-04-14T17:00:00,ITA,16,Puglia,41.12559576,16.86736689,611,62,673,1879,2552,40,53,288,278,3118,33071,null,,,11,-9,2,38,2,11,53,1149
2020-04-15T17:00:00,ITA,16,Puglia,41.12559576,16.86736689,592,73,665,1908,2573,21,66,323,288,3184,34518,null,,,-19,11,-8,29,35,10,66,1447
2020-04-16T17:00:00,ITA,16,Puglia,41.12559576,16.86736689,603,58,661,1964,2625,52,74,334,299,3258,36158,null,,,11,-15,-4,56,11,11,74,1640
2020-04-17T17:00:00,ITA,16,Puglia,41.12559576,16.86736689,590,62,652,2004,2656,31,69,364,307,3327,38278,null,,,-13,4,-9,40,30,8,69,2120
2020-04-18T17:00:00,ITA,16,Puglia,41.12559576,16.86736689,594,60,654,2040,2694,38,82,401,314,3409,40423,null,,,4,-2,2,36,37,7,82,2145
2020-04-19T17:00:00,ITA,16,Puglia,41.12559576,16.86736689,590,60,650,2136,2786,92,120,427,316,3529,42598,41580,,,-4,0,-4,96,26,2,120,2175
2020-04-20T17:00:00,ITA,16,Puglia,41.12559576,16.86736689,584,66,650,2160,2810,24,38,431,326,3567,44189,43119,,,-6,6,0,24,4,10,38,1591
2020-04-21T17:00:00,ITA,16,Puglia,41.12559576,16.86736689,569,65,634,2178,2812,2,55,459,351,3622,45984,44760,,,-15,-1,-16,18,28,25,55,1795
2020-04-22T17:00:00,ITA,16,Puglia,41.12559576,16.86736689,564,60,624,2250,2874,62,108,494,362,3730,48342,46925,,,-5,-5,-10,72,35,11,108,2358
2020-04-23T17:00:00,ITA,16,Puglia,41.12559576,16.86736689,536,55,591,2345,2936,62,109,531,372,3839,50410,49403,,,-28,-5,-33,95,37,10,109,2068
2020-04-24T17:00:00,ITA,16,Puglia,41.12559576,16.86736689,496,51,547,2386,2933,-3,42,565,383,3881,52472,51517,,,-40,-4,-44,41,34,11,42,2062
2020-04-25T17:00:00,ITA,16,Puglia,41.12559576,16.86736689,469,48,517,2402,2919,-14,31,602,391,3912,54628,53500,,,-27,-3,-30,16,37,8,31,2156
2020-04-26T17:00:00,ITA,16,Puglia,41.12559576,16.86736689,464,48,512,2425,2937,18,36,612,399,3948,55992,55397,,,-5,0,-5,23,10,8,36,1364
2020-04-27T17:00:00,ITA,16,Puglia,41.12559576,16.86736689,449,51,500,2412,2912,-25,10,641,405,3958,56976,55897,,,-15,3,-12,-13,29,6,10,984
2020-04-28T17:00:00,ITA,16,Puglia,41.12559576,16.86736689,448,51,499,2420,2919,7,22,654,407,3980,58496,57574,,,-1,0,-1,8,13,2,22,1520
2020-04-29T17:00:00,ITA,16,Puglia,41.12559576,16.86736689,449,47,496,2431,2927,8,49,692,410,4029,60334,59801,,,1,-4,-3,11,38,3,49,1838
2020-04-30T17:00:00,ITA,16,Puglia,41.12559576,16.86736689,439,42,481,2468,2949,22,43,708,415,4072,62460,61439,,,-10,-5,-15,37,16,5,43,2126
2020-05-01T17:00:00,ITA,16,Puglia,41.12559576,16.86736689,428,39,467,2480,2947,-2,27,731,421,4099,64292,62702,,,-11,-3,-14,12,23,6,27,1832
2020-05-02T17:00:00,ITA,16,Puglia,41.12559576,16.86736689,416,39,455,2499,2954,7,34,757,422,4133,65370,63782,,,-12,0,-12,19,26,1,34,1078
2020-02-24T18:00:00,ITA,17,Basilicata,40.63947052,15.80514834,0,0,0,0,0,0,0,0,0,0,0,null,,,0,0,0,0,0,0,0,0
2020-02-25T18:00:00,ITA,17,Basilicata,40.63947052,15.80514834,0,0,0,0,0,0,0,0,0,0,0,null,,,0,0,0,0,0,0,0,0
2020-02-26T18:00:00,ITA,17,Basilicata,40.63947052,15.80514834,0,0,0,0,0,0,0,0,0,0,0,null,,,0,0,0,0,0,0,0,0
2020-02-27T18:00:00,ITA,17,Basilicata,40.63947052,15.80514834,0,0,0,0,0,0,0,0,0,0,0,null,,,0,0,0,0,0,0,0,0
2020-02-28T18:00:00,ITA,17,Basilicata,40.63947052,15.80514834,0,0,0,0,0,0,0,0,0,0,0,null,,,0,0,0,0,0,0,0,0
2020-02-29T17:00:00,ITA,17,Basilicata,40.63947052,15.80514834,0,0,0,0,0,0,0,0,0,0,32,null,,,0,0,0,0,0,0,0,32
2020-03-01T17:00:00,ITA,17,Basilicata,40.63947052,15.80514834,0,0,0,0,0,0,0,0,0,0,39,null,,,0,0,0,0,0,0,0,7
2020-03-02T18:00:00,ITA,17,Basilicata,40.63947052,15.80514834,0,0,0,0,0,0,0,0,0,0,39,null,,,0,0,0,0,0,0,0,0
2020-03-03T18:00:00,ITA,17,Basilicata,40.63947052,15.80514834,0,0,0,1,1,1,1,0,0,1,42,null,,,0,0,0,1,0,0,1,3
2020-03-04T17:00:00,ITA,17,Basilicata,40.63947052,15.80514834,0,0,0,1,1,0,0,0,0,1,48,null,,,0,0,0,0,0,0,0,6
2020-03-05T17:00:00,ITA,17,Basilicata,40.63947052,15.80514834,0,0,0,1,1,0,0,0,0,1,54,null,,,0,0,0,0,0,0,0,6
2020-03-06T17:00:00,ITA,17,Basilicata,40.63947052,15.80514834,1,0,1,2,3,2,2,0,0,3,63,null,,,1,0,1,1,0,0,2,9
2020-03-07T18:00:00,ITA,17,Basilicata,40.63947052,15.80514834,1,0,1,2,3,0,0,0,0,3,75,null,,,0,0,0,0,0,0,0,12
2020-03-08T18:00:00,ITA,17,Basilicata,40.63947052,15.80514834,2,0,2,2,4,1,1,0,0,4,123,null,,,1,0,1,0,0,0,1,48
2020-03-09T18:00:00,ITA,17,Basilicata,40.63947052,15.80514834,2,0,2,3,5,1,1,0,0,5,135,null,,,0,0,0,1,0,0,1,12
2020-03-10T18:00:00,ITA,17,Basilicata,40.63947052,15.80514834,2,0,2,5,7,2,2,0,0,7,148,null,,,0,0,0,2,0,0,2,13
2020-03-11T17:00:00,ITA,17,Basilicata,40.63947052,15.80514834,1,1,2,6,8,1,1,0,0,8,155,null,,,-1,1,0,1,0,0,1,7
2020-03-12T17:00:00,ITA,17,Basilicata,40.63947052,15.80514834,1,1,2,6,8,0,0,0,0,8,155,null,,,0,0,0,0,0,0,0,0
2020-03-13T17:00:00,ITA,17,Basilicata,40.63947052,15.80514834,1,1,2,8,10,2,2,0,0,10,155,null,,,0,0,0,2,0,0,2,0
2020-03-14T17:00:00,ITA,17,Basilicata,40.63947052,15.80514834,0,2,2,8,10,0,0,0,0,10,155,null,,,-1,1,0,0,0,0,0,0
2020-03-15T17:00:00,ITA,17,Basilicata,40.63947052,15.80514834,0,2,2,9,11,1,1,0,0,11,208,null,,,0,0,0,1,0,0,1,53
2020-03-16T17:00:00,ITA,17,Basilicata,40.63947052,15.80514834,1,2,3,9,12,1,1,0,0,12,230,null,,,1,0,1,0,0,0,1,22
2020-03-17T17:00:00,ITA,17,Basilicata,40.63947052,15.80514834,5,2,7,13,20,8,8,0,0,20,262,null,,,4,0,4,4,0,0,8,32
2020-03-18T17:00:00,ITA,17,Basilicata,40.63947052,15.80514834,9,2,11,16,27,7,7,0,0,27,262,null,,,4,0,4,3,0,0,7,0
2020-03-19T17:00:00,ITA,17,Basilicata,40.63947052,15.80514834,8,5,13,24,37,10,10,0,0,37,353,null,,,-1,3,2,8,0,0,10,91
2020-03-20T17:00:00,ITA,17,Basilicata,40.63947052,15.80514834,8,5,13,39,52,15,15,0,0,52,443,null,,,0,0,0,15,0,0,15,90
2020-03-21T17:00:00,ITA,17,Basilicata,40.63947052,15.80514834,12,7,19,47,66,14,14,0,0,66,522,null,,,4,2,6,8,0,0,14,79
2020-03-22T17:00:00,ITA,17,Basilicata,40.63947052,15.80514834,13,10,23,58,81,15,15,0,0,81,643,null,,,1,3,4,11,0,0,15,121
2020-03-23T17:00:00,ITA,17,Basilicata,40.63947052,15.80514834,15,12,27,62,89,8,9,0,1,90,696,null,,,2,2,4,4,0,1,9,53
2020-03-24T17:00:00,ITA,17,Basilicata,40.63947052,15.80514834,14,12,26,65,91,2,2,0,1,92,744,null,,,-1,0,-1,3,0,0,2,48
2020-03-25T17:00:00,ITA,17,Basilicata,40.63947052,15.80514834,20,14,34,78,112,21,21,0,1,113,857,null,,,6,2,8,13,0,0,21,113
2020-03-26T17:00:00,ITA,17,Basilicata,40.63947052,15.80514834,22,16,38,95,133,21,21,0,1,134,1046,null,,,2,2,4,17,0,0,21,189
2020-03-27T17:00:00,ITA,17,Basilicata,40.63947052,15.80514834,22,15,37,110,147,14,17,1,3,151,1254,null,,,0,-1,-1,15,1,2,17,208
2020-03-28T17:00:00,ITA,17,Basilicata,40.63947052,15.80514834,26,19,45,133,178,31,31,1,3,182,1421,null,,,4,4,8,23,0,0,31,167
2020-03-29T17:00:00,ITA,17,Basilicata,40.63947052,15.80514834,32,18,50,147,197,19,20,1,4,202,1585,null,,,6,-1,5,14,0,1,20,164
2020-03-30T17:00:00,ITA,17,Basilicata,40.63947052,15.80514834,36,18,54,154,208,11,12,1,5,214,1833,null,,,4,0,4,7,0,1,12,248
2020-03-31T17:00:00,ITA,17,Basilicata,40.63947052,15.80514834,37,17,54,162,216,8,12,3,7,226,2043,null,,,1,-1,0,8,2,2,12,210
2020-04-01T17:00:00,ITA,17,Basilicata,40.63947052,15.80514834,39,15,54,171,225,9,11,3,9,237,2262,null,,,2,-2,0,9,0,2,11,219
2020-04-02T17:00:00,ITA,17,Basilicata,40.63947052,15.80514834,38,19,57,176,233,8,9,3,10,246,2427,null,,,-1,4,3,5,0,1,9,165
2020-04-03T17:00:00,ITA,17,Basilicata,40.63947052,15.80514834,41,19,60,187,247,14,15,3,11,261,2622,null,,,3,0,3,11,0,1,15,195
2020-04-04T17:00:00,ITA,17,Basilicata,40.63947052,15.80514834,44,19,63,181,244,-3,3,9,11,264,2765,null,,,3,0,3,-6,6,0,3,143
2020-04-05T17:00:00,ITA,17,Basilicata,40.63947052,15.80514834,46,18,64,190,254,10,14,11,13,278,2931,null,,,2,-1,1,9,2,2,14,166
2020-04-06T17:00:00,ITA,17,Basilicata,40.63947052,15.80514834,46,18,64,198,262,8,9,12,13,287,3061,null,,,0,0,0,8,1,0,9,130
2020-04-07T17:00:00,ITA,17,Basilicata,40.63947052,15.80514834,47,17,64,201,265,3,4,12,14,291,3160,null,,,1,-1,0,3,0,1,4,99
2020-04-08T17:00:00,ITA,17,Basilicata,40.63947052,15.80514834,48,17,65,205,270,5,6,13,14,297,3296,null,,,1,0,1,4,1,0,6,136
2020-04-09T17:00:00,ITA,17,Basilicata,40.63947052,15.80514834,50,17,67,208,275,5,6,13,15,303,3474,null,,,2,0,2,3,0,1,6,178
2020-04-10T17:00:00,ITA,17,Basilicata,40.63947052,15.80514834,59,15,74,205,279,4,5,14,15,308,3696,null,,,9,-2,7,-3,1,0,5,222
2020-04-11T17:00:00,ITA,17,Basilicata,40.63947052,15.80514834,60,12,72,209,281,2,4,14,17,312,4050,null,,,1,-3,-2,4,0,2,4,354
2020-04-12T17:00:00,ITA,17,Basilicata,40.63947052,15.80514834,61,12,73,204,277,-4,3,20,18,315,4355,null,,,1,0,1,-5,6,1,3,305
2020-04-13T17:00:00,ITA,17,Basilicata,40.63947052,15.80514834,64,12,76,194,270,-7,4,31,18,319,4545,null,,,3,0,3,-10,11,0,4,190
2020-04-14T17:00:00,ITA,17,Basilicata,40.63947052,15.80514834,62,12,74,191,265,-5,0,35,19,319,4759,null,,,-2,0,-2,-3,4,1,0,214
2020-04-15T17:00:00,ITA,17,Basilicata,40.63947052,15.80514834,60,12,72,189,261,-4,1,38,21,320,5037,null,,,-2,0,-2,-2,3,2,1,278
2020-04-16T17:00:00,ITA,17,Basilicata,40.63947052,15.80514834,60,9,69,204,273,12,16,41,22,336,5349,null,,,0,-3,-3,15,3,1,16,312
2020-04-17T17:00:00,ITA,17,Basilicata,40.63947052,15.80514834,59,9,68,198,266,-7,1,49,22,337,5710,null,,,-1,0,-1,-6,8,0,1,361
2020-04-18T17:00:00,ITA,17,Basilicata,40.63947052,15.80514834,60,8,68,194,262,-4,2,54,23,339,6056,null,,,1,-1,0,-4,5,1,2,346
2020-04-19T17:00:00,ITA,17,Basilicata,40.63947052,15.80514834,59,8,67,180,247,-15,3,71,24,342,6528,6528,,,-1,0,-1,-14,17,1,3,472
2020-04-20T17:00:00,ITA,17,Basilicata,40.63947052,15.80514834,59,7,66,176,242,-5,0,76,24,342,6868,6868,,,0,-1,-1,-4,5,0,0,340
2020-04-21T17:00:00,ITA,17,Basilicata,40.63947052,15.80514834,64,7,71,174,245,3,8,81,24,350,7470,7470,,,5,0,5,-2,5,0,8,602
2020-04-22T17:00:00,ITA,17,Basilicata,40.63947052,15.80514834,65,7,72,160,232,-13,4,98,24,354,8040,8040,,,1,0,1,-14,17,0,4,570
2020-04-23T17:00:00,ITA,17,Basilicata,40.63947052,15.80514834,61,7,68,161,229,-3,2,103,24,356,8511,8511,,,-4,0,-4,1,5,0,2,471
2020-04-24T17:00:00,ITA,17,Basilicata,40.63947052,15.80514834,59,7,66,163,229,0,4,107,24,360,9026,9026,,,-2,0,-2,2,4,0,4,515
2020-04-25T17:00:00,ITA,17,Basilicata,40.63947052,15.80514834,58,7,65,153,218,-11,1,118,25,361,9792,9792,,,-1,0,-1,-10,11,1,1,766
2020-04-26T17:00:00,ITA,17,Basilicata,40.63947052,15.80514834,57,7,64,155,219,1,5,122,25,366,10077,10077,,,-1,0,-1,2,4,0,5,285
2020-04-27T17:00:00,ITA,17,Basilicata,40.63947052,15.80514834,57,7,64,153,217,-2,0,124,25,366,10364,10364,,,0,0,0,-2,2,0,0,287
2020-04-28T17:00:00,ITA,17,Basilicata,40.63947052,15.80514834,56,7,63,142,205,-12,0,136,25,366,10889,10889,,,-1,0,-1,-11,12,0,0,525
2020-04-29T17:00:00,ITA,17,Basilicata,40.63947052,15.80514834,51,4,55,139,194,-11,0,147,25,366,11331,11331,,,-5,-3,-8,-3,11,0,0,442
2020-04-30T17:00:00,ITA,17,Basilicata,40.63947052,15.80514834,49,4,53,139,192,-2,1,150,25,367,12774,12774,,,-2,0,-2,0,3,0,1,1443
2020-05-01T17:00:00,ITA,17,Basilicata,40.63947052,15.80514834,49,4,53,140,193,1,11,160,25,378,13269,13269,,,0,0,0,1,10,0,11,495
2020-05-02T17:00:00,ITA,17,Basilicata,40.63947052,15.80514834,48,4,52,139,191,-2,2,164,25,380,13722,13722,,,-1,0,-1,-1,4,0,2,453
2020-02-24T18:00:00,ITA,18,Calabria,38.90597598,16.59440194,0,0,0,0,0,0,0,0,0,0,1,null,,,0,0,0,0,0,0,0,0
2020-02-25T18:00:00,ITA,18,Calabria,38.90597598,16.59440194,0,0,0,0,0,0,0,0,0,0,2,null,,,0,0,0,0,0,0,0,2
2020-02-26T18:00:00,ITA,18,Calabria,38.90597598,16.59440194,0,0,0,0,0,0,0,0,0,0,3,null,,,0,0,0,0,0,0,0,1
2020-02-27T18:00:00,ITA,18,Calabria,38.90597598,16.59440194,0,0,0,0,0,0,0,0,0,0,14,null,,,0,0,0,0,0,0,0,11
2020-02-28T18:00:00,ITA,18,Calabria,38.90597598,16.59440194,0,0,0,1,1,1,1,0,0,1,21,null,,,0,0,0,1,0,0,1,7
2020-02-29T17:00:00,ITA,18,Calabria,38.90597598,16.59440194,0,0,0,1,1,0,0,0,0,1,27,null,,,0,0,0,0,0,0,0,6
2020-03-01T17:00:00,ITA,18,Calabria,38.90597598,16.59440194,0,0,0,1,1,0,0,0,0,1,35,null,,,0,0,0,0,0,0,0,8
2020-03-02T18:00:00,ITA,18,Calabria,38.90597598,16.59440194,0,0,0,1,1,0,0,0,0,1,39,null,,,0,0,0,0,0,0,0,4
2020-03-03T18:00:00,ITA,18,Calabria,38.90597598,16.59440194,0,0,0,1,1,0,0,0,0,1,39,null,,,0,0,0,0,0,0,0,0
2020-03-04T17:00:00,ITA,18,Calabria,38.90597598,16.59440194,0,0,0,1,1,0,0,0,0,1,46,null,,,0,0,0,0,0,0,0,7
2020-03-05T17:00:00,ITA,18,Calabria,38.90597598,16.59440194,1,0,1,1,2,1,1,0,0,2,53,null,,,1,0,1,0,0,0,1,7
2020-03-06T17:00:00,ITA,18,Calabria,38.90597598,16.59440194,2,0,2,2,4,2,2,0,0,4,99,null,,,1,0,1,1,0,0,2,46
2020-03-07T18:00:00,ITA,18,Calabria,38.90597598,16.59440194,2,0,2,2,4,0,0,0,0,4,113,null,,,0,0,0,0,0,0,0,14
2020-03-08T18:00:00,ITA,18,Calabria,38.90597598,16.59440194,5,0,5,4,9,5,5,0,0,9,113,null,,,3,0,3,2,0,0,5,0
2020-03-09T18:00:00,ITA,18,Calabria,38.90597598,16.59440194,8,0,8,1,9,0,2,2,0,11,173,null,,,3,0,3,-3,2,0,2,60
2020-03-10T18:00:00,ITA,18,Calabria,38.90597598,16.59440194,8,2,10,1,11,2,2,2,0,13,360,null,,,0,2,2,0,0,0,2,187
2020-03-11T17:00:00,ITA,18,Calabria,38.90597598,16.59440194,10,2,12,5,17,6,6,2,0,19,405,null,,,2,0,2,4,0,0,6,45
2020-03-12T17:00:00,ITA,18,Calabria,38.90597598,16.59440194,14,2,16,16,32,15,14,1,0,33,483,null,,,4,0,4,11,-1,0,14,78
2020-03-13T17:00:00,ITA,18,Calabria,38.90597598,16.59440194,18,3,21,16,37,5,5,1,0,38,504,null,,,4,1,5,0,0,0,5,21
2020-03-14T17:00:00,ITA,18,Calabria,38.90597598,16.59440194,22,4,26,33,59,22,22,1,0,60,711,null,,,4,1,5,17,0,0,22,207
2020-03-15T17:00:00,ITA,18,Calabria,38.90597598,16.59440194,32,6,38,28,66,7,8,1,1,68,884,null,,,10,2,12,-5,0,1,8,173
2020-03-16T17:00:00,ITA,18,Calabria,38.90597598,16.59440194,36,7,43,44,87,21,21,1,1,89,1030,null,,,4,1,5,16,0,0,21,146
2020-03-17T17:00:00,ITA,18,Calabria,38.90597598,16.59440194,45,10,55,57,112,25,25,1,1,114,1293,null,,,9,3,12,13,0,0,25,263
2020-03-18T17:00:00,ITA,18,Calabria,38.90597598,16.59440194,45,11,56,70,126,14,15,2,1,129,1668,null,,,0,1,1,13,1,0,15,375
2020-03-19T17:00:00,ITA,18,Calabria,38.90597598,16.59440194,60,13,73,91,164,38,40,2,3,169,2342,null,,,15,2,17,21,0,2,40,674
2020-03-20T17:00:00,ITA,18,Calabria,38.90597598,16.59440194,71,16,87,114,201,37,38,2,4,207,2690,null,,,11,3,14,23,0,1,38,348
2020-03-21T17:00:00,ITA,18,Calabria,38.90597598,16.59440194,73,16,89,136,225,24,28,5,5,235,3050,null,,,2,0,2,22,3,1,28,360
2020-03-22T17:00:00,ITA,18,Calabria,38.90597598,16.59440194,77,17,94,166,260,35,38,5,8,273,3666,null,,,4,1,5,30,0,3,38,616
2020-03-23T17:00:00,ITA,18,Calabria,38.90597598,16.59440194,82,20,102,178,280,20,19,5,7,292,4073,null,,,5,3,8,12,0,-1,19,407
2020-03-24T17:00:00,ITA,18,Calabria,38.90597598,16.59440194,88,21,109,195,304,24,27,5,10,319,4486,null,,,6,1,7,17,0,3,27,413
2020-03-25T17:00:00,ITA,18,Calabria,38.90597598,16.59440194,93,23,116,217,333,29,32,7,11,351,5058,null,,,5,2,7,22,2,1,32,572
2020-03-26T17:00:00,ITA,18,Calabria,38.90597598,16.59440194,101,23,124,248,372,39,42,7,14,393,5933,null,,,8,0,8,31,0,3,42,875
2020-03-27T17:00:00,ITA,18,Calabria,38.90597598,16.59440194,103,22,125,344,469,97,101,7,18,494,6901,null,,,2,-1,1,96,0,4,101,968
2020-03-28T17:00:00,ITA,18,Calabria,38.90597598,16.59440194,107,22,129,394,523,54,61,11,21,555,7760,null,,,4,0,4,50,4,3,61,859
2020-03-29T17:00:00,ITA,18,Calabria,38.90597598,16.59440194,124,19,143,434,577,54,59,12,25,614,8485,null,,,17,-3,14,40,1,4,59,725
2020-03-30T17:00:00,ITA,18,Calabria,38.90597598,16.59440194,130,18,148,454,602,25,33,14,31,647,9013,null,,,6,-1,5,20,2,6,33,528
2020-03-31T17:00:00,ITA,18,Calabria,38.90597598,16.59440194,132,17,149,457,606,4,12,17,36,659,9327,null,,,2,-1,1,3,3,5,12,314
2020-04-01T17:00:00,ITA,18,Calabria,38.90597598,16.59440194,144,16,160,450,610,4,10,21,38,669,9983,null,,,12,-1,11,-7,4,2,10,656
2020-04-02T17:00:00,ITA,18,Calabria,38.90597598,16.59440194,163,19,182,445,627,17,22,23,41,691,10679,null,,,19,3,22,-5,2,3,22,696
2020-04-03T17:00:00,ITA,18,Calabria,38.90597598,16.59440194,183,17,200,462,662,35,42,26,45,733,11608,null,,,20,-2,18,17,3,4,42,929
2020-04-04T17:00:00,ITA,18,Calabria,38.90597598,16.59440194,178,15,193,469,662,0,8,30,49,741,12314,null,,,-5,-2,-7,7,4,4,8,706
2020-04-05T17:00:00,ITA,18,Calabria,38.90597598,16.59440194,174,13,187,519,706,44,54,33,56,795,13077,null,,,-4,-2,-6,50,3,7,54,763
2020-04-06T17:00:00,ITA,18,Calabria,38.90597598,16.59440194,170,14,184,538,722,16,22,37,58,817,13633,null,,,-4,1,-3,19,4,2,22,556
2020-04-07T17:00:00,ITA,18,Calabria,38.90597598,16.59440194,169,14,183,550,733,11,16,40,60,833,14072,null,,,-1,0,-1,12,3,2,16,439
2020-04-08T17:00:00,ITA,18,Calabria,38.90597598,16.59440194,170,15,185,570,755,22,26,44,60,859,14977,null,,,1,1,2,20,4,0,26,905
2020-04-09T17:00:00,ITA,18,Calabria,38.90597598,16.59440194,168,15,183,582,765,10,15,48,61,874,15698,null,,,-2,0,-2,12,4,1,15,721
2020-04-10T17:00:00,ITA,18,Calabria,38.90597598,16.59440194,168,14,182,604,786,21,27,50,65,901,16637,null,,,0,-1,-1,22,2,4,27,939
2020-04-11T17:00:00,ITA,18,Calabria,38.90597598,16.59440194,169,15,184,608,792,6,14,57,66,915,17493,null,,,1,1,2,4,7,1,14,856
2020-04-12T17:00:00,ITA,18,Calabria,38.90597598,16.59440194,165,14,179,616,795,3,8,62,66,923,18211,null,,,-4,-1,-5,8,5,0,8,718
2020-04-13T17:00:00,ITA,18,Calabria,38.90597598,16.59440194,160,12,172,619,791,-4,5,70,67,928,18596,null,,,-5,-2,-7,3,8,1,5,385
2020-04-14T17:00:00,ITA,18,Calabria,38.90597598,16.59440194,161,12,173,643,816,25,28,72,68,956,19014,null,,,1,0,1,24,2,1,28,418
2020-04-15T17:00:00,ITA,18,Calabria,38.90597598,16.59440194,156,11,167,652,819,3,15,81,71,971,19662,null,,,-5,-1,-6,9,9,3,15,648
2020-04-16T17:00:00,ITA,18,Calabria,38.90597598,16.59440194,157,9,166,681,847,28,38,90,72,1009,20642,null,,,1,-2,-1,29,9,1,38,980
2020-04-17T17:00:00,ITA,18,Calabria,38.90597598,16.59440194,154,7,161,658,819,-28,-18,99,73,991,21657,null,,,-3,-2,-5,-23,9,1,-18,1015
2020-04-18T17:00:00,ITA,18,Calabria,38.90597598,16.59440194,152,7,159,673,832,13,20,106,73,1011,22794,null,,,-2,0,-2,15,7,0,20,1137
2020-04-19T17:00:00,ITA,18,Calabria,38.90597598,16.59440194,142,6,148,696,844,12,24,116,75,1035,23760,22234,,,-10,-1,-11,23,10,2,24,966
2020-04-20T17:00:00,ITA,18,Calabria,38.90597598,16.59440194,140,7,147,681,828,-16,3,135,75,1038,24373,22847,,,-2,1,-1,-15,19,0,3,613
2020-04-21T17:00:00,ITA,18,Calabria,38.90597598,16.59440194,133,7,140,679,819,-9,9,152,76,1047,25440,23914,,,-7,0,-7,-2,17,1,9,1067
2020-04-22T17:00:00,ITA,18,Calabria,38.90597598,16.59440194,128,7,135,686,821,2,13,163,76,1060,26560,24878,,,-5,0,-5,7,11,0,13,1120
2020-04-23T17:00:00,ITA,18,Calabria,38.90597598,16.59440194,129,7,136,687,823,2,9,170,76,1069,27869,26187,,,1,0,1,1,7,0,9,1309
2020-04-24T17:00:00,ITA,18,Calabria,38.90597598,16.59440194,123,7,130,691,821,-2,10,178,80,1079,28764,26811,,,-6,0,-6,4,8,4,10,895
2020-04-25T17:00:00,ITA,18,Calabria,38.90597598,16.59440194,125,7,132,679,811,-10,9,197,80,1088,29959,28006,,,2,0,2,-12,19,0,9,1195
2020-04-26T17:00:00,ITA,18,Calabria,38.90597598,16.59440194,118,8,126,671,797,-14,1,212,80,1089,30853,28900,,,-7,1,-6,-8,15,0,1,894
2020-04-27T17:00:00,ITA,18,Calabria,38.90597598,16.59440194,114,6,120,662,782,-15,7,231,83,1096,31787,29834,,,-4,-2,-6,-9,19,3,7,934
2020-04-28T17:00:00,ITA,18,Calabria,38.90597598,16.59440194,113,6,119,645,764,-18,1,248,85,1097,33755,31802,,,-1,0,-1,-17,17,2,1,1968
2020-04-29T17:00:00,ITA,18,Calabria,38.90597598,16.59440194,107,6,113,640,753,-11,5,263,86,1102,34914,32961,,,-6,0,-6,-5,15,1,5,1159
2020-04-30T17:00:00,ITA,18,Calabria,38.90597598,16.59440194,105,6,111,629,740,-13,6,282,86,1108,35903,33950,,,-2,0,-2,-11,19,0,6,989
2020-05-01T17:00:00,ITA,18,Calabria,38.90597598,16.59440194,105,3,108,619,727,-13,4,299,86,1112,37054,35101,,,0,-3,-3,-10,17,0,4,1151
2020-05-02T17:00:00,ITA,18,Calabria,38.90597598,16.59440194,100,4,104,609,713,-14,0,311,88,1112,37928,35975,,,-5,1,-4,-10,12,2,0,874
2020-02-24T18:00:00,ITA,19,Sicilia,38.11569725,13.3623567,0,0,0,0,0,0,0,0,0,0,5,null,,,0,0,0,0,0,0,0,0
2020-02-25T18:00:00,ITA,19,Sicilia,38.11569725,13.3623567,1,0,1,2,3,3,3,0,0,3,5,null,,,1,0,1,2,0,0,3,5
2020-02-26T18:00:00,ITA,19,Sicilia,38.11569725,13.3623567,1,0,1,2,3,0,0,0,0,3,5,null,,,0,0,0,0,0,0,0,0
2020-02-27T18:00:00,ITA,19,Sicilia,38.11569725,13.3623567,1,0,1,1,2,-1,1,2,0,4,5,null,,,0,0,0,-1,2,0,1,0
2020-02-28T18:00:00,ITA,19,Sicilia,38.11569725,13.3623567,1,0,1,1,2,0,0,2,0,4,5,null,,,0,0,0,0,0,0,0,0
2020-02-29T17:00:00,ITA,19,Sicilia,38.11569725,13.3623567,1,0,1,1,2,0,0,2,0,4,6,null,,,0,0,0,0,0,0,0,1
2020-03-01T17:00:00,ITA,19,Sicilia,38.11569725,13.3623567,1,0,1,6,7,5,5,2,0,9,291,null,,,0,0,0,5,0,0,5,285
2020-03-02T18:00:00,ITA,19,Sicilia,38.11569725,13.3623567,2,0,2,3,5,-2,-2,2,0,7,307,null,,,1,0,1,-3,0,0,-2,16
2020-03-03T18:00:00,ITA,19,Sicilia,38.11569725,13.3623567,2,0,2,3,5,0,0,2,0,7,307,null,,,0,0,0,0,0,0,0,0
2020-03-04T17:00:00,ITA,19,Sicilia,38.11569725,13.3623567,5,0,5,11,16,11,11,2,0,18,367,null,,,3,0,3,8,0,0,11,60
2020-03-05T17:00:00,ITA,19,Sicilia,38.11569725,13.3623567,5,0,5,11,16,0,0,2,0,18,367,null,,,0,0,0,0,0,0,0,0
2020-03-06T17:00:00,ITA,19,Sicilia,38.11569725,13.3623567,7,0,7,15,22,6,6,2,0,24,367,null,,,2,0,2,4,0,0,6,0
2020-03-07T18:00:00,ITA,19,Sicilia,38.11569725,13.3623567,8,0,8,25,33,11,11,2,0,35,643,null,,,1,0,1,10,0,0,11,276
2020-03-08T18:00:00,ITA,19,Sicilia,38.11569725,13.3623567,18,0,18,33,51,18,18,2,0,53,791,null,,,10,0,10,8,0,0,18,148
2020-03-09T18:00:00,ITA,19,Sicilia,38.11569725,13.3623567,19,0,19,33,52,1,1,2,0,54,836,null,,,1,0,1,0,0,0,1,45
2020-03-10T18:00:00,ITA,19,Sicilia,38.11569725,13.3623567,17,2,19,41,60,8,8,2,0,62,955,null,,,-2,2,0,8,0,0,8,119
2020-03-11T17:00:00,ITA,19,Sicilia,38.11569725,13.3623567,23,1,24,57,81,21,21,2,0,83,1194,null,,,6,-1,5,16,0,0,21,239
2020-03-12T17:00:00,ITA,19,Sicilia,38.11569725,13.3623567,28,5,33,78,111,30,32,2,2,115,1477,null,,,5,4,9,21,0,2,32,283
2020-03-13T17:00:00,ITA,19,Sicilia,38.11569725,13.3623567,37,7,44,82,126,15,15,2,2,130,1950,null,,,9,2,11,4,0,0,15,473
2020-03-14T17:00:00,ITA,19,Sicilia,38.11569725,13.3623567,42,11,53,97,150,24,26,4,2,156,2100,null,,,5,4,9,15,2,0,26,150
2020-03-15T17:00:00,ITA,19,Sicilia,38.11569725,13.3623567,56,15,71,108,179,29,32,7,2,188,2452,null,,,14,4,18,11,3,0,32,352
2020-03-16T17:00:00,ITA,19,Sicilia,38.11569725,13.3623567,75,20,95,108,203,24,25,8,2,213,2653,null,,,19,5,24,0,1,0,25,201
2020-03-17T17:00:00,ITA,19,Sicilia,38.11569725,13.3623567,86,28,114,112,226,23,24,8,3,237,2916,null,,,11,8,19,4,0,1,24,263
2020-03-18T17:00:00,ITA,19,Sicilia,38.11569725,13.3623567,100,29,129,138,267,41,45,12,3,282,3294,null,,,14,1,15,26,4,0,45,378
2020-03-19T17:00:00,ITA,19,Sicilia,38.11569725,13.3623567,143,36,179,142,321,54,58,15,4,340,3961,null,,,43,7,50,4,3,1,58,667
2020-03-20T17:00:00,ITA,19,Sicilia,38.11569725,13.3623567,168,42,210,169,379,58,68,25,4,408,4468,null,,,25,6,31,27,10,0,68,507
2020-03-21T17:00:00,ITA,19,Sicilia,38.11569725,13.3623567,206,48,254,204,458,79,82,26,6,490,4883,null,,,38,6,44,35,1,2,82,415
2020-03-22T17:00:00,ITA,19,Sicilia,38.11569725,13.3623567,220,55,275,321,596,138,140,26,8,630,5580,null,,,14,7,21,117,0,2,140,697
2020-03-23T17:00:00,ITA,19,Sicilia,38.11569725,13.3623567,250,60,310,371,681,85,91,27,13,721,6375,null,,,30,5,35,50,1,5,91,795
2020-03-24T17:00:00,ITA,19,Sicilia,38.11569725,13.3623567,250,60,310,489,799,118,125,27,20,846,7170,null,,,0,0,0,118,0,7,125,795
2020-03-25T17:00:00,ITA,19,Sicilia,38.11569725,13.3623567,259,80,339,597,936,137,148,33,25,994,8312,null,,,9,20,29,108,6,5,148,1142
2020-03-26T17:00:00,ITA,19,Sicilia,38.11569725,13.3623567,346,68,414,681,1095,159,170,36,33,1164,9658,null,,,87,-12,75,84,3,8,170,1346
2020-03-27T17:00:00,ITA,19,Sicilia,38.11569725,13.3623567,425,75,500,658,1158,63,86,53,39,1250,11079,null,,,79,7,86,-23,17,6,86,1421
2020-03-28T17:00:00,ITA,19,Sicilia,38.11569725,13.3623567,441,71,512,730,1242,84,109,60,57,1359,13096,null,,,16,-4,12,72,7,18,109,2017
2020-03-29T17:00:00,ITA,19,Sicilia,38.11569725,13.3623567,451,71,522,808,1330,88,101,65,65,1460,13814,null,,,10,0,10,78,5,8,101,718
2020-03-30T17:00:00,ITA,19,Sicilia,38.11569725,13.3623567,484,75,559,849,1408,78,95,71,76,1555,14758,null,,,33,4,37,41,6,11,95,944
2020-03-31T17:00:00,ITA,19,Sicilia,38.11569725,13.3623567,503,72,575,917,1492,84,92,74,81,1647,15634,null,,,19,-3,16,68,3,5,92,876
2020-04-01T17:00:00,ITA,19,Sicilia,38.11569725,13.3623567,496,72,568,976,1544,52,71,86,88,1718,16836,null,,,-7,0,-7,59,12,7,71,1202
2020-04-02T17:00:00,ITA,19,Sicilia,38.11569725,13.3623567,503,73,576,1030,1606,62,73,92,93,1791,17833,null,,,7,1,8,54,6,5,73,997
2020-04-03T17:00:00,ITA,19,Sicilia,38.11569725,13.3623567,535,73,608,1056,1664,58,68,94,101,1859,18686,null,,,32,0,32,26,2,8,68,853
2020-04-04T17:00:00,ITA,19,Sicilia,38.11569725,13.3623567,553,74,627,1099,1726,62,73,95,111,1932,19896,null,,,18,1,19,43,1,10,73,1210
2020-04-05T17:00:00,ITA,19,Sicilia,38.11569725,13.3623567,556,76,632,1142,1774,48,62,104,116,1994,21904,null,,,3,2,5,43,9,5,62,2008
2020-04-06T17:00:00,ITA,19,Sicilia,38.11569725,13.3623567,563,74,637,1178,1815,41,52,108,123,2046,23464,null,,,7,-2,5,36,4,7,52,1560
2020-04-07T17:00:00,ITA,19,Sicilia,38.11569725,13.3623567,562,73,635,1224,1859,44,51,113,125,2097,24857,null,,,-1,-1,-2,46,5,2,51,1393
2020-04-08T17:00:00,ITA,19,Sicilia,38.11569725,13.3623567,563,65,628,1265,1893,34,62,133,133,2159,27438,null,,,1,-8,-7,41,20,8,62,2581
2020-04-09T17:00:00,ITA,19,Sicilia,38.11569725,13.3623567,566,63,629,1313,1942,49,73,152,138,2232,28742,null,,,3,-2,1,48,19,5,73,1304
2020-04-10T17:00:00,ITA,19,Sicilia,38.11569725,13.3623567,568,62,630,1337,1967,25,70,187,148,2302,31156,null,,,2,-1,1,24,35,10,70,2414
2020-04-11T17:00:00,ITA,19,Sicilia,38.11569725,13.3623567,562,58,620,1381,2001,34,62,209,154,2364,33787,null,,,-6,-4,-10,44,22,6,62,2631
2020-04-12T17:00:00,ITA,19,Sicilia,38.11569725,13.3623567,552,53,605,1425,2030,29,52,223,163,2416,36098,null,,,-10,-5,-15,44,14,9,52,2311
2020-04-13T17:00:00,ITA,19,Sicilia,38.11569725,13.3623567,554,51,605,1445,2050,20,42,237,171,2458,37311,null,,,2,-2,0,20,14,8,42,1213
2020-04-14T17:00:00,ITA,19,Sicilia,38.11569725,13.3623567,552,53,605,1466,2071,21,43,255,175,2501,37877,null,,,-2,2,0,21,18,4,43,566
2020-04-15T17:00:00,ITA,19,Sicilia,38.11569725,13.3623567,541,49,590,1491,2081,10,34,273,181,2535,39867,null,,,-11,-4,-15,25,18,6,34,1990
2020-04-16T17:00:00,ITA,19,Sicilia,38.11569725,13.3623567,525,48,573,1535,2108,27,44,284,187,2579,42405,null,,,-16,-1,-17,44,11,6,44,2538
2020-04-17T17:00:00,ITA,19,Sicilia,38.11569725,13.3623567,521,46,567,1572,2139,31,46,296,190,2625,45172,null,,,-4,-2,-6,37,12,3,46,2767
2020-04-18T17:00:00,ITA,19,Sicilia,38.11569725,13.3623567,526,42,568,1603,2171,32,47,305,196,2672,47715,null,,,5,-4,1,31,9,6,47,2543
2020-04-19T17:00:00,ITA,19,Sicilia,38.11569725,13.3623567,522,41,563,1639,2202,31,45,315,200,2717,49772,49772,,,-4,-1,-5,36,10,4,45,2057
2020-04-20T17:00:00,ITA,19,Sicilia,38.11569725,13.3623567,526,39,565,1645,2210,8,42,346,203,2759,51373,51373,,,4,-2,2,6,31,3,42,1601
2020-04-21T17:00:00,ITA,19,Sicilia,38.11569725,13.3623567,514,37,551,1708,2259,49,76,370,206,2835,55093,55093,,,-12,-2,-14,63,24,3,76,3720
2020-04-22T17:00:00,ITA,19,Sicilia,38.11569725,13.3623567,500,35,535,1752,2287,28,48,388,208,2883,58732,58732,,,-14,-2,-16,44,18,2,48,3639
2020-04-23T17:00:00,ITA,19,Sicilia,38.11569725,13.3623567,476,34,510,1791,2301,14,43,412,213,2926,62150,62150,,,-24,-1,-25,39,24,5,43,3418
2020-04-24T17:00:00,ITA,19,Sicilia,38.11569725,13.3623567,461,32,493,1827,2320,19,55,443,218,2981,65165,63626,,,-15,-2,-17,36,31,5,55,3015
2020-04-25T17:00:00,ITA,19,Sicilia,38.11569725,13.3623567,452,33,485,1787,2272,-48,39,524,224,3020,68251,64892,,,-9,1,-8,-40,81,6,39,3086
2020-04-26T17:00:00,ITA,19,Sicilia,38.11569725,13.3623567,445,33,478,1629,2107,-165,35,720,228,3055,70104,65689,,,-7,0,-7,-158,196,4,35,1853
2020-04-27T17:00:00,ITA,19,Sicilia,38.11569725,13.3623567,440,35,475,1648,2123,16,30,731,231,3085,70650,66749,,,-5,2,-3,19,11,3,30,546
2020-04-28T17:00:00,ITA,19,Sicilia,38.11569725,13.3623567,428,34,462,1681,2143,20,35,745,232,3120,73008,68729,,,-12,-1,-13,33,14,1,35,2358
2020-04-29T17:00:00,ITA,19,Sicilia,38.11569725,13.3623567,415,34,449,1696,2145,2,20,763,232,3140,75360,71301,,,-13,0,-13,15,18,0,20,2352
2020-04-30T17:00:00,ITA,19,Sicilia,38.11569725,13.3623567,408,33,441,1716,2157,12,26,774,235,3166,79669,74541,,,-7,-1,-8,20,11,3,26,4309
2020-05-01T17:00:00,ITA,19,Sicilia,38.11569725,13.3623567,399,30,429,1742,2171,14,28,786,237,3194,82860,77490,,,-9,-3,-12,26,12,2,28,3191
2020-05-02T17:00:00,ITA,19,Sicilia,38.11569725,13.3623567,396,30,426,1760,2186,15,19,787,240,3213,84352,77590,,,-3,0,-3,18,1,3,19,1492
2020-02-24T18:00:00,ITA,2,Valle d\'Aosta,45.73750286,7.320149366,0,0,0,0,0,0,0,0,0,0,7,null,,,0,0,0,0,0,0,0,0
2020-02-25T18:00:00,ITA,2,Valle d\'Aosta,45.73750286,7.320149366,0,0,0,0,0,0,0,0,0,0,7,null,,,0,0,0,0,0,0,0,7
2020-02-26T18:00:00,ITA,2,Valle d\'Aosta,45.73750286,7.320149366,0,0,0,0,0,0,0,0,0,0,7,null,,,0,0,0,0,0,0,0,0
2020-02-27T18:00:00,ITA,2,Valle d\'Aosta,45.73750286,7.320149366,0,0,0,0,0,0,0,0,0,0,9,null,,,0,0,0,0,0,0,0,2
2020-02-28T18:00:00,ITA,2,Valle d\'Aosta,45.73750286,7.320149366,0,0,0,0,0,0,0,0,0,0,9,null,,,0,0,0,0,0,0,0,0
2020-02-29T17:00:00,ITA,2,Valle d\'Aosta,45.73750286,7.320149366,0,0,0,0,0,0,0,0,0,0,9,null,,,0,0,0,0,0,0,0,0
2020-03-01T17:00:00,ITA,2,Valle d\'Aosta,45.73750286,7.320149366,0,0,0,0,0,0,0,0,0,0,10,null,,,0,0,0,0,0,0,0,1
2020-03-02T18:00:00,ITA,2,Valle d\'Aosta,45.73750286,7.320149366,0,0,0,0,0,0,0,0,0,0,11,null,,,0,0,0,0,0,0,0,1
2020-03-03T18:00:00,ITA,2,Valle d\'Aosta,45.73750286,7.320149366,0,0,0,0,0,0,0,0,0,0,12,null,,,0,0,0,0,0,0,0,1
2020-03-04T17:00:00,ITA,2,Valle d\'Aosta,45.73750286,7.320149366,0,0,0,0,0,0,0,0,0,0,15,null,,,0,0,0,0,0,0,0,3
2020-03-05T17:00:00,ITA,2,Valle d\'Aosta,45.73750286,7.320149366,0,0,0,2,2,2,2,0,0,2,21,null,,,0,0,0,2,0,0,2,6
2020-03-06T17:00:00,ITA,2,Valle d\'Aosta,45.73750286,7.320149366,0,0,0,7,7,5,5,0,0,7,28,null,,,0,0,0,5,0,0,5,7
2020-03-07T18:00:00,ITA,2,Valle d\'Aosta,45.73750286,7.320149366,1,0,1,7,8,1,1,0,0,8,32,null,,,1,0,1,0,0,0,1,4
2020-03-08T18:00:00,ITA,2,Valle d\'Aosta,45.73750286,7.320149366,1,0,1,8,9,1,1,0,0,9,41,null,,,0,0,0,1,0,0,1,9
2020-03-09T18:00:00,ITA,2,Valle d\'Aosta,45.73750286,7.320149366,4,0,4,11,15,6,6,0,0,15,67,null,,,3,0,3,3,0,0,6,26
2020-03-10T18:00:00,ITA,2,Valle d\'Aosta,45.73750286,7.320149366,2,0,2,15,17,2,2,0,0,17,89,null,,,-2,0,-2,4,0,0,2,22
2020-03-11T17:00:00,ITA,2,Valle d\'Aosta,45.73750286,7.320149366,2,0,2,17,19,2,3,0,1,20,99,null,,,0,0,0,2,0,1,3,10
2020-03-12T17:00:00,ITA,2,Valle d\'Aosta,45.73750286,7.320149366,7,0,7,19,26,7,7,0,1,27,118,null,,,5,0,5,2,0,0,7,19
2020-03-13T17:00:00,ITA,2,Valle d\'Aosta,45.73750286,7.320149366,6,0,6,21,27,1,1,0,1,28,189,null,,,-1,0,-1,2,0,0,1,71
2020-03-14T17:00:00,ITA,2,Valle d\'Aosta,45.73750286,7.320149366,12,0,12,29,41,14,14,0,1,42,231,null,,,6,0,6,8,0,0,14,42
2020-03-15T17:00:00,ITA,2,Valle d\'Aosta,45.73750286,7.320149366,10,3,13,43,56,15,15,0,1,57,230,null,,,-2,3,1,14,0,0,15,-1
2020-03-16T17:00:00,ITA,2,Valle d\'Aosta,45.73750286,7.320149366,28,5,33,70,103,47,48,0,2,105,287,null,,,18,2,20,27,0,1,48,57
2020-03-17T17:00:00,ITA,2,Valle d\'Aosta,45.73750286,7.320149366,35,6,41,93,134,31,31,0,2,136,398,null,,,7,1,8,23,0,0,31,111
2020-03-18T17:00:00,ITA,2,Valle d\'Aosta,45.73750286,7.320149366,41,3,44,118,162,28,29,0,3,165,486,null,,,6,-3,3,25,0,1,29,88
2020-03-19T17:00:00,ITA,2,Valle d\'Aosta,45.73750286,7.320149366,47,9,56,153,209,47,50,0,6,215,608,null,,,6,6,12,35,0,3,50,122
2020-03-20T17:00:00,ITA,2,Valle d\'Aosta,45.73750286,7.320149366,54,9,63,194,257,48,49,0,7,264,814,null,,,7,0,7,41,0,1,49,206
2020-03-21T17:00:00,ITA,2,Valle d\'Aosta,45.73750286,7.320149366,62,15,77,227,304,47,49,1,8,313,884,null,,,8,6,14,33,1,1,49,70
2020-03-22T17:00:00,ITA,2,Valle d\'Aosta,45.73750286,7.320149366,63,21,84,270,354,50,51,1,9,364,950,null,,,1,6,7,43,0,1,51,66
2020-03-23T17:00:00,ITA,2,Valle d\'Aosta,45.73750286,7.320149366,69,20,89,290,379,25,29,2,12,393,1098,null,,,6,-1,5,20,1,3,29,148
2020-03-24T17:00:00,ITA,2,Valle d\'Aosta,45.73750286,7.320149366,71,20,91,288,379,0,7,2,19,400,1180,null,,,2,0,2,-2,0,7,7,82
2020-03-25T17:00:00,ITA,2,Valle d\'Aosta,45.73750286,7.320149366,70,25,95,280,375,-4,1,2,24,401,1200,null,,,-1,5,4,-8,0,5,1,20
2020-03-26T17:00:00,ITA,2,Valle d\'Aosta,45.73750286,7.320149366,73,24,97,281,378,3,7,2,28,408,1203,null,,,3,-1,2,1,0,4,7,3
2020-03-27T17:00:00,ITA,2,Valle d\'Aosta,45.73750286,7.320149366,91,24,115,298,413,35,44,2,37,452,1252,null,,,18,0,18,17,0,9,44,49
2020-03-28T17:00:00,ITA,2,Valle d\'Aosta,45.73750286,7.320149366,90,26,116,352,468,55,59,2,41,511,1380,null,,,-1,2,1,54,0,4,59,128
2020-03-29T17:00:00,ITA,2,Valle d\'Aosta,45.73750286,7.320149366,90,26,116,423,539,71,73,2,43,584,1480,null,,,0,0,0,71,0,2,73,100
2020-03-30T17:00:00,ITA,2,Valle d\'Aosta,45.73750286,7.320149366,92,26,118,400,518,-21,0,16,50,584,1536,null,,,2,0,2,-23,14,7,0,56
2020-03-31T17:00:00,ITA,2,Valle d\'Aosta,45.73750286,7.320149366,91,26,117,435,552,34,44,20,56,628,1582,null,,,-1,0,-1,35,4,6,44,46
2020-04-01T17:00:00,ITA,2,Valle d\'Aosta,45.73750286,7.320149366,85,27,112,428,540,-12,3,32,59,631,1717,null,,,-6,1,-5,-7,12,3,3,135
2020-04-02T17:00:00,ITA,2,Valle d\'Aosta,45.73750286,7.320149366,85,25,110,446,556,16,37,49,63,668,1934,null,,,0,-2,-2,18,17,4,37,217
2020-04-03T17:00:00,ITA,2,Valle d\'Aosta,45.73750286,7.320149366,85,25,110,450,560,4,51,89,70,719,2106,null,,,0,0,0,4,40,7,51,172
2020-04-04T17:00:00,ITA,2,Valle d\'Aosta,45.73750286,7.320149366,63,23,86,474,560,0,29,106,82,748,2274,null,,,-22,-2,-24,24,17,12,29,168
2020-04-05T17:00:00,ITA,2,Valle d\'Aosta,45.73750286,7.320149366,96,23,119,457,576,16,34,115,91,782,2390,null,,,33,0,33,-17,9,9,34,116
2020-04-06T17:00:00,ITA,2,Valle d\'Aosta,45.73750286,7.320149366,109,21,130,437,567,-9,23,142,96,805,2590,null,,,13,-2,11,-20,27,5,23,200
2020-04-07T17:00:00,ITA,2,Valle d\'Aosta,45.73750286,7.320149366,118,17,135,458,593,26,30,142,100,835,2754,null,,,9,-4,5,21,0,4,30,164
2020-04-08T17:00:00,ITA,2,Valle d\'Aosta,45.73750286,7.320149366,120,20,140,466,606,13,15,142,102,850,2953,null,,,2,3,5,8,0,2,15,199
2020-04-09T17:00:00,ITA,2,Valle d\'Aosta,45.73750286,7.320149366,118,18,136,473,609,3,18,154,105,868,3142,null,,,-2,-2,-4,7,12,3,18,189
2020-04-10T17:00:00,ITA,2,Valle d\'Aosta,45.73750286,7.320149366,131,16,147,455,602,-7,11,170,107,879,3328,null,,,13,-2,11,-18,16,2,11,186
2020-04-11T17:00:00,ITA,2,Valle d\'Aosta,45.73750286,7.320149366,118,17,135,455,590,-12,23,205,107,902,3464,null,,,-13,1,-12,0,35,0,23,136
2020-04-12T17:00:00,ITA,2,Valle d\'Aosta,45.73750286,7.320149366,109,16,125,463,588,-2,19,221,112,921,3510,null,,,-9,-1,-10,8,16,5,19,46
2020-04-13T17:00:00,ITA,2,Valle d\'Aosta,45.73750286,7.320149366,109,15,124,458,582,-6,6,230,115,927,3614,null,,,0,-1,-1,-5,9,3,6,104
2020-04-14T17:00:00,ITA,2,Valle d\'Aosta,45.73750286,7.320149366,112,14,126,433,559,-23,20,270,118,947,3726,null,,,3,-1,2,-25,40,3,20,112
2020-04-15T17:00:00,ITA,2,Valle d\'Aosta,45.73750286,7.320149366,112,11,123,425,548,-11,11,289,121,958,3894,null,,,0,-3,-3,-8,19,3,11,168
2020-04-16T17:00:00,ITA,2,Valle d\'Aosta,45.73750286,7.320149366,105,12,117,401,518,-30,13,331,122,971,4159,null,,,-7,1,-6,-24,42,1,13,265
2020-04-17T17:00:00,ITA,2,Valle d\'Aosta,45.73750286,7.320149366,108,9,117,374,491,-27,22,379,123,993,4366,null,,,3,-3,0,-27,48,1,22,207
2020-04-18T17:00:00,ITA,2,Valle d\'Aosta,45.73750286,7.320149366,107,10,117,432,549,58,80,400,124,1073,4521,null,,,-1,1,0,58,21,1,80,155
2020-04-19T17:00:00,ITA,2,Valle d\'Aosta,45.73750286,7.320149366,102,10,112,450,562,13,15,401,125,1088,4677,3802,,,-5,0,-5,18,1,1,15,156
2020-04-20T17:00:00,ITA,2,Valle d\'Aosta,45.73750286,7.320149366,102,8,110,438,548,-14,0,413,127,1088,4799,3910,,,0,-2,-2,-12,12,2,0,122
2020-04-21T17:00:00,ITA,2,Valle d\'Aosta,45.73750286,7.320149366,99,8,107,415,522,-26,5,445,126,1093,4911,3969,,,-3,0,-3,-23,32,-1,5,112
2020-04-22T17:00:00,ITA,2,Valle d\'Aosta,45.73750286,7.320149366,92,8,100,401,501,-21,2,467,127,1095,5024,4011,,,-7,0,-7,-14,22,1,2,113
2020-04-23T17:00:00,ITA,2,Valle d\'Aosta,45.73750286,7.320149366,91,9,100,363,463,-38,1,506,127,1096,5227,4133,,,-1,1,0,-38,39,0,1,203
2020-04-24T17:00:00,ITA,2,Valle d\'Aosta,45.73750286,7.320149366,88,7,95,259,354,-109,4,617,129,1100,5262,4454,,,-3,-2,-5,-104,111,2,4,35
2020-04-25T17:00:00,ITA,2,Valle d\'Aosta,45.73750286,7.320149366,83,6,89,224,313,-41,0,657,130,1100,5966,4694,,,-5,-1,-6,-35,40,1,0,704
2020-04-26T17:00:00,ITA,2,Valle d\'Aosta,45.73750286,7.320149366,82,7,89,165,254,-59,6,721,131,1106,6135,4624,dc-IT-0012,dc-EN-0012,-1,1,0,-59,64,1,6,169
2020-04-27T17:00:00,ITA,2,Valle d\'Aosta,45.73750286,7.320149366,86,7,93,142,235,-19,5,743,133,1111,6551,4873,,,4,0,4,-23,22,2,5,416
2020-04-28T17:00:00,ITA,2,Valle d\'Aosta,45.73750286,7.320149366,81,5,86,123,209,-26,8,775,135,1119,6897,5069,,,-5,-2,-7,-19,32,2,8,346
2020-04-29T17:00:00,ITA,2,Valle d\'Aosta,45.73750286,7.320149366,78,5,83,52,135,-74,5,852,137,1124,7181,5337,,,-3,0,-3,-71,77,2,5,284
2020-04-30T17:00:00,ITA,2,Valle d\'Aosta,45.73750286,7.320149366,76,4,80,9,89,-46,4,902,137,1128,7631,5647,,,-2,-1,-3,-43,50,0,4,450
2020-05-01T17:00:00,ITA,2,Valle d\'Aosta,45.73750286,7.320149366,72,3,75,17,92,3,5,904,137,1133,7769,5818,,,-4,-1,-5,8,2,0,5,138
2020-05-02T17:00:00,ITA,2,Valle d\'Aosta,45.73750286,7.320149366,70,3,73,25,98,6,3,901,137,1136,7951,5931,,,-2,0,-2,8,-3,0,3,182
2020-02-24T18:00:00,ITA,20,Sardegna,39.21531192,9.110616306,0,0,0,0,0,0,0,0,0,0,1,null,,,0,0,0,0,0,0,0,0
2020-02-25T18:00:00,ITA,20,Sardegna,39.21531192,9.110616306,0,0,0,0,0,0,0,0,0,0,1,null,,,0,0,0,0,0,0,0,1
2020-02-26T18:00:00,ITA,20,Sardegna,39.21531192,9.110616306,0,0,0,0,0,0,0,0,0,0,1,null,,,0,0,0,0,0,0,0,0
2020-02-27T18:00:00,ITA,20,Sardegna,39.21531192,9.110616306,0,0,0,0,0,0,0,0,0,0,1,null,,,0,0,0,0,0,0,0,0
2020-02-28T18:00:00,ITA,20,Sardegna,39.21531192,9.110616306,0,0,0,0,0,0,0,0,0,0,1,null,,,0,0,0,0,0,0,0,0
2020-02-29T17:00:00,ITA,20,Sardegna,39.21531192,9.110616306,0,0,0,0,0,0,0,0,0,0,1,null,,,0,0,0,0,0,0,0,0
2020-03-01T17:00:00,ITA,20,Sardegna,39.21531192,9.110616306,0,0,0,0,0,0,0,0,0,0,29,null,,,0,0,0,0,0,0,0,28
2020-03-02T18:00:00,ITA,20,Sardegna,39.21531192,9.110616306,0,0,0,0,0,0,0,0,0,0,29,null,,,0,0,0,0,0,0,0,0
2020-03-03T18:00:00,ITA,20,Sardegna,39.21531192,9.110616306,1,0,1,0,1,1,1,0,0,1,29,null,,,1,0,1,0,0,0,1,0
2020-03-04T17:00:00,ITA,20,Sardegna,39.21531192,9.110616306,1,0,1,1,2,1,1,0,0,2,42,null,,,0,0,0,1,0,0,1,13
2020-03-05T17:00:00,ITA,20,Sardegna,39.21531192,9.110616306,2,0,2,0,2,0,0,0,0,2,50,null,,,1,0,1,-1,0,0,0,8
2020-03-06T17:00:00,ITA,20,Sardegna,39.21531192,9.110616306,2,0,2,3,5,3,3,0,0,5,99,null,,,0,0,0,3,0,0,3,49
2020-03-07T18:00:00,ITA,20,Sardegna,39.21531192,9.110616306,2,0,2,3,5,0,0,0,0,5,99,null,,,0,0,0,0,0,0,0,0
2020-03-08T18:00:00,ITA,20,Sardegna,39.21531192,9.110616306,5,0,5,6,11,6,6,0,0,11,149,null,,,3,0,3,3,0,0,6,50
2020-03-09T18:00:00,ITA,20,Sardegna,39.21531192,9.110616306,8,0,8,11,19,8,8,0,0,19,185,null,,,3,0,3,5,0,0,8,36
2020-03-10T18:00:00,ITA,20,Sardegna,39.21531192,9.110616306,9,0,9,11,20,1,1,0,0,20,204,null,,,1,0,1,0,0,0,1,19
2020-03-11T17:00:00,ITA,20,Sardegna,39.21531192,9.110616306,10,0,10,27,37,17,17,0,0,37,283,null,,,1,0,1,16,0,0,17,79
2020-03-12T17:00:00,ITA,20,Sardegna,39.21531192,9.110616306,12,0,12,27,39,2,2,0,0,39,302,null,,,2,0,2,0,0,0,2,19
2020-03-13T17:00:00,ITA,20,Sardegna,39.21531192,9.110616306,12,0,12,31,43,4,4,0,0,43,504,null,,,0,0,0,4,0,0,4,202
2020-03-14T17:00:00,ITA,20,Sardegna,39.21531192,9.110616306,14,0,14,33,47,4,4,0,0,47,530,null,,,2,0,2,2,0,0,4,26
2020-03-15T17:00:00,ITA,20,Sardegna,39.21531192,9.110616306,16,0,16,59,75,28,30,0,2,77,613,null,,,2,0,2,26,0,2,30,83
2020-03-16T17:00:00,ITA,20,Sardegna,39.21531192,9.110616306,39,0,39,66,105,30,30,0,2,107,797,null,,,23,0,23,7,0,0,30,184
2020-03-17T17:00:00,ITA,20,Sardegna,39.21531192,9.110616306,36,4,40,75,115,10,10,0,2,117,1003,null,,,-3,4,1,9,0,0,10,206
2020-03-18T17:00:00,ITA,20,Sardegna,39.21531192,9.110616306,42,7,49,83,132,17,17,0,2,134,1135,null,,,6,3,9,8,0,0,17,132
2020-03-19T17:00:00,ITA,20,Sardegna,39.21531192,9.110616306,43,9,52,152,204,72,72,0,2,206,1334,null,,,1,2,3,69,0,0,72,199
2020-03-20T17:00:00,ITA,20,Sardegna,39.21531192,9.110616306,56,15,71,217,288,84,87,3,2,293,1912,null,,,13,6,19,65,3,0,87,578
2020-03-21T17:00:00,ITA,20,Sardegna,39.21531192,9.110616306,65,16,81,240,321,33,37,5,4,330,2297,null,,,9,1,10,23,2,2,37,385
2020-03-22T17:00:00,ITA,20,Sardegna,39.21531192,9.110616306,67,16,83,244,327,6,9,5,7,339,2402,null,,,2,0,2,4,0,3,9,105
2020-03-23T17:00:00,ITA,20,Sardegna,39.21531192,9.110616306,76,18,94,249,343,16,20,5,11,359,2568,null,,,9,2,11,5,0,4,20,166
2020-03-24T17:00:00,ITA,20,Sardegna,39.21531192,9.110616306,80,19,99,296,395,52,62,11,15,421,2859,null,,,4,1,5,47,6,4,62,291
2020-03-25T17:00:00,ITA,20,Sardegna,39.21531192,9.110616306,82,19,101,311,412,17,21,12,18,442,3019,null,,,2,0,2,15,1,3,21,160
2020-03-26T17:00:00,ITA,20,Sardegna,39.21531192,9.110616306,92,20,112,350,462,50,52,13,19,494,3461,null,,,10,1,11,39,1,1,52,442
2020-03-27T17:00:00,ITA,20,Sardegna,39.21531192,9.110616306,93,19,112,384,496,34,36,13,21,530,3801,null,,,1,-1,0,34,0,2,36,340
2020-03-28T17:00:00,ITA,20,Sardegna,39.21531192,9.110616306,95,22,117,452,569,73,94,29,26,624,4225,null,,,2,3,5,68,16,5,94,424
2020-03-29T17:00:00,ITA,20,Sardegna,39.21531192,9.110616306,105,23,128,454,582,13,14,29,27,638,4598,null,,,10,1,11,2,0,1,14,373
2020-03-30T17:00:00,ITA,20,Sardegna,39.21531192,9.110616306,113,24,137,485,622,40,44,32,28,682,4993,null,,,8,1,9,31,3,1,44,395
2020-03-31T17:00:00,ITA,20,Sardegna,39.21531192,9.110616306,113,28,141,516,657,35,40,34,31,722,5257,null,,,0,4,4,31,2,3,40,264
2020-04-01T17:00:00,ITA,20,Sardegna,39.21531192,9.110616306,119,27,146,529,675,18,23,36,34,745,5501,null,,,6,-1,5,13,2,3,23,244
2020-04-02T17:00:00,ITA,20,Sardegna,39.21531192,9.110616306,117,24,141,577,718,43,49,36,40,794,5970,null,,,-2,-3,-5,48,0,6,49,469
2020-04-03T17:00:00,ITA,20,Sardegna,39.21531192,9.110616306,122,24,146,598,744,26,31,40,41,825,6478,null,,,5,0,5,21,4,1,31,508
2020-04-04T17:00:00,ITA,20,Sardegna,39.21531192,9.110616306,123,24,147,642,789,45,49,44,41,874,6789,null,,,1,0,1,44,4,0,49,311
2020-04-05T17:00:00,ITA,20,Sardegna,39.21531192,9.110616306,126,25,151,664,815,26,33,49,43,907,7157,null,,,3,1,4,22,5,2,33,368
2020-04-06T17:00:00,ITA,20,Sardegna,39.21531192,9.110616306,123,26,149,670,819,4,15,56,47,922,7521,null,,,-3,1,-2,6,7,4,15,364
2020-04-07T17:00:00,ITA,20,Sardegna,39.21531192,9.110616306,122,26,148,673,821,2,13,62,52,935,7680,null,,,-1,0,-1,3,6,5,13,159
2020-04-08T17:00:00,ITA,20,Sardegna,39.21531192,9.110616306,112,31,143,697,840,19,40,76,59,975,8493,null,,,-10,5,-5,24,14,7,40,813
2020-04-09T17:00:00,ITA,20,Sardegna,39.21531192,9.110616306,106,25,131,745,876,36,51,86,64,1026,8918,null,,,-6,-6,-12,48,10,5,51,425
2020-04-10T17:00:00,ITA,20,Sardegna,39.21531192,9.110616306,107,26,133,743,876,0,37,118,69,1063,9444,null,,,1,1,2,-2,32,5,37,526
2020-04-11T17:00:00,ITA,20,Sardegna,39.21531192,9.110616306,113,24,137,751,888,12,28,130,73,1091,10120,null,,,6,-2,4,8,12,4,28,676
2020-04-12T17:00:00,ITA,20,Sardegna,39.21531192,9.110616306,109,26,135,768,903,15,22,137,73,1113,10663,null,,,-4,2,-2,17,7,0,22,543
2020-04-13T17:00:00,ITA,20,Sardegna,39.21531192,9.110616306,107,27,134,780,914,11,15,139,75,1128,11010,null,,,-2,1,-1,12,2,2,15,347
2020-04-14T17:00:00,ITA,20,Sardegna,39.21531192,9.110616306,107,24,131,769,900,-14,10,158,80,1138,11893,null,,,0,-3,-3,-11,19,5,10,883
2020-04-15T17:00:00,ITA,20,Sardegna,39.21531192,9.110616306,107,26,133,737,870,-30,23,208,83,1161,12395,null,,,0,2,2,-32,50,3,23,502
2020-04-16T17:00:00,ITA,20,Sardegna,39.21531192,9.110616306,109,24,133,732,865,-5,3,214,85,1164,12796,null,,,2,-2,0,-5,6,2,3,401
2020-04-17T17:00:00,ITA,20,Sardegna,39.21531192,9.110616306,113,23,136,736,872,7,14,220,86,1178,13304,null,,,4,-1,3,4,6,1,14,508
2020-04-18T17:00:00,ITA,20,Sardegna,39.21531192,9.110616306,112,23,135,746,881,9,20,231,86,1198,14087,null,,,-1,0,-1,10,11,0,20,783
2020-04-19T17:00:00,ITA,20,Sardegna,39.21531192,9.110616306,117,22,139,725,864,-17,17,265,86,1215,14859,13760,,,5,-1,4,-21,34,0,17,772
2020-04-20T17:00:00,ITA,20,Sardegna,39.21531192,9.110616306,115,21,136,718,854,-10,13,288,86,1228,15328,14160,,,-2,-1,-3,-7,23,0,13,469
2020-04-21T17:00:00,ITA,20,Sardegna,39.21531192,9.110616306,112,21,133,704,837,-17,8,306,93,1236,15886,14526,,,-3,0,-3,-14,18,7,8,558
2020-04-22T17:00:00,ITA,20,Sardegna,39.21531192,9.110616306,97,20,117,716,833,-4,11,318,96,1247,16886,15354,,,-15,-1,-16,12,12,3,11,1000
2020-04-23T17:00:00,ITA,20,Sardegna,39.21531192,9.110616306,90,20,110,707,817,-16,7,339,98,1254,17844,16094,,,-7,0,-7,-9,21,2,7,958
2020-04-24T17:00:00,ITA,20,Sardegna,39.21531192,9.110616306,95,19,114,690,804,-13,3,351,102,1257,19889,18050,dc-IT-0010,dc-EN-0010,5,-1,4,-17,12,4,3,2045
2020-04-25T17:00:00,ITA,20,Sardegna,39.21531192,9.110616306,96,18,114,680,794,-10,14,374,103,1271,20351,18480,,,1,-1,0,-10,23,1,14,462
2020-04-26T17:00:00,ITA,20,Sardegna,39.21531192,9.110616306,95,20,115,668,783,-11,9,388,109,1280,21101,19162,,,-1,2,1,-12,14,6,9,750
2020-04-27T17:00:00,ITA,20,Sardegna,39.21531192,9.110616306,97,19,116,660,776,-7,3,398,109,1283,21395,19424,,,2,-1,1,-8,10,0,3,294
2020-04-28T17:00:00,ITA,20,Sardegna,39.21531192,9.110616306,96,18,114,658,772,-4,2,404,109,1285,22116,20053,,,-1,-1,-2,-2,6,0,2,721
2020-04-29T17:00:00,ITA,20,Sardegna,39.21531192,9.110616306,87,17,104,657,761,-11,5,413,116,1290,23299,21071,,,-9,-1,-10,-1,9,7,5,1183
2020-04-30T17:00:00,ITA,20,Sardegna,39.21531192,9.110616306,87,16,103,641,744,-17,5,435,116,1295,24754,22358,,,0,-1,-1,-16,22,0,5,1455
2020-05-01T17:00:00,ITA,20,Sardegna,39.21531192,9.110616306,84,12,96,648,744,0,18,452,117,1313,26242,23442,,,-3,-4,-7,7,17,1,18,1488
2020-05-02T17:00:00,ITA,20,Sardegna,39.21531192,9.110616306,86,13,99,631,730,-14,2,466,119,1315,26990,24065,,,2,1,3,-17,14,2,2,748
2020-02-24T18:00:00,ITA,3,Lombardia,45.46679409,9.190347404,76,19,95,71,166,0,166,0,6,172,1463,null,,,0,0,0,0,0,0,0,0
2020-02-25T18:00:00,ITA,3,Lombardia,45.46679409,9.190347404,79,25,104,127,231,65,68,0,9,240,3700,null,,,79,25,104,127,0,9,240,3700
2020-02-26T18:00:00,ITA,3,Lombardia,45.46679409,9.190347404,79,25,104,145,249,18,18,0,9,258,3208,null,,,0,0,0,18,0,0,18,-492
2020-02-27T18:00:00,ITA,3,Lombardia,45.46679409,9.190347404,172,41,213,136,349,100,145,40,14,403,3320,null,,,93,16,109,-9,40,5,145,112
2020-02-28T18:00:00,ITA,3,Lombardia,45.46679409,9.190347404,235,47,282,192,474,125,128,40,17,531,4835,null,,,63,6,69,56,0,3,128,1515
2020-02-29T17:00:00,ITA,3,Lombardia,45.46679409,9.190347404,256,80,336,216,552,78,84,40,23,615,5723,null,,,21,33,54,24,0,6,84,888
2020-03-01T17:00:00,ITA,3,Lombardia,45.46679409,9.190347404,406,106,512,375,887,335,369,73,24,984,6879,null,,,150,26,176,159,33,1,369,1156
2020-03-02T18:00:00,ITA,3,Lombardia,45.46679409,9.190347404,478,127,605,472,1077,190,270,139,38,1254,7925,null,,,72,21,93,97,66,14,270,1046
2020-03-03T18:00:00,ITA,3,Lombardia,45.46679409,9.190347404,698,167,865,461,1326,249,266,139,55,1520,9577,null,,,220,40,260,-11,0,17,266,1652
2020-03-04T17:00:00,ITA,3,Lombardia,45.46679409,9.190347404,877,209,1086,411,1497,171,300,250,73,1820,12138,null,,,179,42,221,-50,111,18,300,2561
2020-03-05T17:00:00,ITA,3,Lombardia,45.46679409,9.190347404,1169,244,1413,364,1777,280,431,376,98,2251,12354,null,,,292,35,327,-47,126,25,431,216
2020-03-06T17:00:00,ITA,3,Lombardia,45.46679409,9.190347404,1622,309,1931,77,2008,231,361,469,135,2612,13556,null,,,453,65,518,-287,93,37,361,1202
2020-03-07T18:00:00,ITA,3,Lombardia,45.46679409,9.190347404,1661,359,2020,722,2742,734,808,524,154,3420,15778,null,pd-IT-0002,pd-EN-0002,39,50,89,645,55,19,808,2222
2020-03-08T18:00:00,ITA,3,Lombardia,45.46679409,9.190347404,2217,399,2616,756,3372,630,769,550,267,4189,18534,null,,,556,40,596,34,26,113,769,2756
2020-03-09T18:00:00,ITA,3,Lombardia,45.46679409,9.190347404,2802,440,3242,1248,4490,1118,1280,646,333,5469,20135,null,,,585,41,626,492,96,66,1280,1601
2020-03-10T18:00:00,ITA,3,Lombardia,45.46679409,9.190347404,3319,466,3785,642,4427,-63,322,896,468,5791,21479,null,pd-IT-0004,pd-EN-0004,517,26,543,-606,250,135,322,1344
2020-03-11T17:00:00,ITA,3,Lombardia,45.46679409,9.190347404,3852,560,4412,1351,5763,1336,1489,900,617,7280,25629,null,,,533,94,627,709,4,149,1489,4150
2020-03-12T17:00:00,ITA,3,Lombardia,45.46679409,9.190347404,4247,605,4852,2044,6896,1133,1445,1085,744,8725,29534,null,,,395,45,440,693,185,127,1445,3905
2020-03-13T17:00:00,ITA,3,Lombardia,45.46679409,9.190347404,4435,650,5085,2647,7732,836,1095,1198,890,9820,32700,null,,,188,45,233,603,113,146,1095,3166
2020-03-14T17:00:00,ITA,3,Lombardia,45.46679409,9.190347404,4898,732,5630,3429,9059,1327,1865,1660,966,11685,37138,null,,,463,82,545,782,462,76,1865,4438
2020-03-15T17:00:00,ITA,3,Lombardia,45.46679409,9.190347404,5500,767,6267,3776,10043,984,1587,2011,1218,13272,40369,null,,,602,35,637,347,351,252,1587,3231
2020-03-16T17:00:00,ITA,3,Lombardia,45.46679409,9.190347404,6171,823,6994,3867,10861,818,1377,2368,1420,14649,43565,null,,,671,56,727,91,357,202,1377,3196
2020-03-17T17:00:00,ITA,3,Lombardia,45.46679409,9.190347404,6953,879,7832,4263,12095,1234,1571,2485,1640,16220,46449,null,,,782,56,838,396,117,220,1571,2884
2020-03-18T17:00:00,ITA,3,Lombardia,45.46679409,9.190347404,7285,924,8209,4057,12266,171,1493,3488,1959,17713,48983,null,,,332,45,377,-206,1003,319,1493,2534
2020-03-19T17:00:00,ITA,3,Lombardia,45.46679409,9.190347404,7387,1006,8393,5545,13938,1672,2171,3778,2168,19884,52244,null,,,102,82,184,1488,290,209,2171,3261
2020-03-20T17:00:00,ITA,3,Lombardia,45.46679409,9.190347404,7735,1050,8785,6635,15420,1482,2380,4295,2549,22264,57174,null,,,348,44,392,1090,517,381,2380,4930
2020-03-21T17:00:00,ITA,3,Lombardia,45.46679409,9.190347404,8258,1093,9351,8019,17370,1950,3251,5050,3095,25515,66730,null,,,523,43,566,1384,755,546,3251,9556
2020-03-22T17:00:00,ITA,3,Lombardia,45.46679409,9.190347404,9439,1142,10581,7304,17885,515,1691,5865,3456,27206,70598,null,,,1181,49,1230,-715,815,361,1691,3868
2020-03-23T17:00:00,ITA,3,Lombardia,45.46679409,9.190347404,9266,1183,10449,8461,18910,1025,1555,6075,3776,28761,73242,null,,,-173,41,-132,1157,210,320,1555,2644
2020-03-24T17:00:00,ITA,3,Lombardia,45.46679409,9.190347404,9711,1194,10905,8963,19868,958,1942,6657,4178,30703,76695,null,,,445,11,456,502,582,402,1942,3453
2020-03-25T17:00:00,ITA,3,Lombardia,45.46679409,9.190347404,10026,1236,11262,9329,20591,723,1643,7281,4474,32346,81666,null,,,315,42,357,366,624,296,1643,4971
2020-03-26T17:00:00,ITA,3,Lombardia,45.46679409,9.190347404,10681,1263,11944,10245,22189,1598,2543,7839,4861,34889,87713,null,,,655,27,682,916,558,387,2543,6047
2020-03-27T17:00:00,ITA,3,Lombardia,45.46679409,9.190347404,11137,1292,12429,11466,23895,1706,2409,8001,5402,37298,95860,null,,,456,29,485,1221,162,541,2409,8147
2020-03-28T17:00:00,ITA,3,Lombardia,45.46679409,9.190347404,11152,1319,12471,12038,24509,614,2117,8962,5944,39415,102503,null,,,15,27,42,572,961,542,2117,6643
2020-03-29T17:00:00,ITA,3,Lombardia,45.46679409,9.190347404,11613,1328,12941,12451,25392,883,1592,9255,6360,41007,107398,null,,,461,9,470,413,293,416,1592,4895
2020-03-30T17:00:00,ITA,3,Lombardia,45.46679409,9.190347404,11815,1330,13145,11861,25006,-386,1154,10337,6818,42161,111057,null,,,202,2,204,-590,1082,458,1154,3659
2020-03-31T17:00:00,ITA,3,Lombardia,45.46679409,9.190347404,11883,1324,13207,11917,25124,118,1047,10885,7199,43208,114640,null,,,68,-6,62,56,548,381,1047,3583
2020-04-01T17:00:00,ITA,3,Lombardia,45.46679409,9.190347404,11927,1342,13269,12496,25765,641,1565,11415,7593,44773,121449,null,,,44,18,62,579,530,394,1565,6809
2020-04-02T17:00:00,ITA,3,Lombardia,45.46679409,9.190347404,11762,1351,13113,12763,25876,111,1292,12229,7960,46065,128286,null,,,-165,9,-156,267,814,367,1292,6837
2020-04-03T17:00:00,ITA,3,Lombardia,45.46679409,9.190347404,11802,1381,13183,13006,26189,313,1455,13020,8311,47520,135051,null,,,40,30,70,243,791,351,1455,6765
2020-04-04T17:00:00,ITA,3,Lombardia,45.46679409,9.190347404,12002,1326,13328,13892,27220,1031,1598,13242,8656,49118,141877,null,,,200,-55,145,886,222,345,1598,6826
2020-04-05T17:00:00,ITA,3,Lombardia,45.46679409,9.190347404,12009,1317,13326,14798,28124,904,1337,13426,8905,50455,149984,null,,,7,-9,-2,906,184,249,1337,8107
2020-04-06T17:00:00,ITA,3,Lombardia,45.46679409,9.190347404,11914,1343,13257,15212,28469,345,1079,13863,9202,51534,154989,null,,,-95,26,-69,414,437,297,1079,5005
2020-04-07T17:00:00,ITA,3,Lombardia,45.46679409,9.190347404,11833,1305,13138,15205,28343,-126,791,14498,9484,52325,159331,null,,,-81,-38,-119,-7,635,282,791,4342
2020-04-08T17:00:00,ITA,3,Lombardia,45.46679409,9.190347404,11719,1257,12976,15569,28545,202,1089,15147,9722,53414,167557,null,,,-114,-48,-162,364,649,238,1089,8226
2020-04-09T17:00:00,ITA,3,Lombardia,45.46679409,9.190347404,11796,1236,13032,16042,29074,529,1388,15706,10022,54802,176953,null,,,77,-21,56,473,559,300,1388,9396
2020-04-10T17:00:00,ITA,3,Lombardia,45.46679409,9.190347404,11877,1202,13079,16451,29530,456,1246,16280,10238,56048,186325,null,,,81,-34,47,409,574,216,1246,9372
2020-04-11T17:00:00,ITA,3,Lombardia,45.46679409,9.190347404,12026,1174,13200,17058,30258,728,1544,16823,10511,57592,196302,null,,,149,-28,121,607,543,273,1544,9977
2020-04-12T17:00:00,ITA,3,Lombardia,45.46679409,9.190347404,11969,1176,13145,18120,31265,1007,1460,17166,10621,59052,205832,null,,,-57,2,-55,1062,343,110,1460,9530
2020-04-13T17:00:00,ITA,3,Lombardia,45.46679409,9.190347404,12028,1143,13171,18764,31935,670,1262,17478,10901,60314,211092,null,,,59,-33,26,644,312,280,1262,5260
2020-04-14T17:00:00,ITA,3,Lombardia,45.46679409,9.190347404,12077,1122,13199,19164,32363,428,1012,17821,11142,61326,214870,null,,,49,-21,28,400,343,241,1012,3778
2020-04-15T17:00:00,ITA,3,Lombardia,45.46679409,9.190347404,12043,1074,13117,19804,32921,558,827,17855,11377,62153,221968,null,,,-34,-48,-82,640,34,235,827,7098
2020-04-16T17:00:00,ITA,3,Lombardia,45.46679409,9.190347404,11356,1032,12388,20702,33090,169,941,18396,11608,63094,232674,null,,,-687,-42,-729,898,541,231,941,10706
2020-04-17T17:00:00,ITA,3,Lombardia,45.46679409,9.190347404,10627,971,11598,21836,33434,344,1041,18850,11851,64135,243513,null,,,-729,-61,-790,1134,454,243,1041,10839
2020-04-18T17:00:00,ITA,3,Lombardia,45.46679409,9.190347404,10042,947,10989,23206,34195,761,1246,19136,12050,65381,255331,null,,,-585,-24,-609,1370,286,199,1246,11818
2020-04-19T17:00:00,ITA,3,Lombardia,45.46679409,9.190347404,10342,922,11264,23233,34497,302,855,19526,12213,66236,264155,183757,,,300,-25,275,27,390,163,855,8824
2020-04-20T17:00:00,ITA,3,Lombardia,45.46679409,9.190347404,10138,901,11039,23548,34587,90,735,20008,12376,66971,270486,173333,,,-204,-21,-225,315,482,163,735,6331
2020-04-21T17:00:00,ITA,3,Lombardia,45.46679409,9.190347404,9805,851,10656,23322,33978,-609,960,21374,12579,67931,277197,173333,pd-IT-0012,pd-EN-0012,-333,-50,-383,-226,1366,203,960,6711
2020-04-22T17:00:00,ITA,3,Lombardia,45.46679409,9.190347404,9692,817,10509,23733,34242,264,1161,22110,12740,69092,290699,184323,,,-113,-34,-147,411,736,161,1161,13502
2020-04-23T17:00:00,ITA,3,Lombardia,45.46679409,9.190347404,9192,790,9982,23891,33873,-369,1073,23352,12940,70165,302715,190451,,,-500,-27,-527,158,1242,200,1073,12016
2020-04-24T17:00:00,ITA,3,Lombardia,45.46679409,9.190347404,8791,756,9547,24821,34368,495,1091,23782,13106,71256,314298,196406,,,-401,-34,-435,930,430,166,1091,11583
2020-04-25T17:00:00,ITA,3,Lombardia,45.46679409,9.190347404,8489,724,9213,25260,34473,105,713,24227,13269,71969,326940,202827,,,-302,-32,-334,439,445,163,713,12642
2020-04-26T17:00:00,ITA,3,Lombardia,45.46679409,9.190347404,8481,706,9187,25979,35166,693,920,24398,13325,72889,337797,208471,,,-8,-18,-26,719,171,56,920,10857
2020-04-27T17:00:00,ITA,3,Lombardia,45.46679409,9.190347404,7525,680,8205,27236,35441,275,590,24589,13449,73479,342850,211523,,,-956,-26,-982,1257,191,124,590,5053
2020-04-28T17:00:00,ITA,3,Lombardia,45.46679409,9.190347404,7280,655,7935,27809,35744,303,869,25029,13575,74348,351423,216526,,,-245,-25,-270,573,440,126,869,8573
2020-04-29T17:00:00,ITA,3,Lombardia,45.46679409,9.190347404,7120,634,7754,28368,36122,378,786,25333,13679,75134,365895,223952,,,-160,-21,-181,559,304,104,786,14472
2020-04-30T17:00:00,ITA,3,Lombardia,45.46679409,9.190347404,6834,605,7439,28772,36211,89,598,25749,13772,75732,376943,229880,,,-286,-29,-315,404,416,93,598,11048
2020-05-01T17:00:00,ITA,3,Lombardia,45.46679409,9.190347404,6628,563,7191,29282,36473,262,737,26136,13860,76469,390644,236822,,,-206,-42,-248,510,387,88,737,13701
2020-05-02T17:00:00,ITA,3,Lombardia,45.46679409,9.190347404,6529,545,7074,29593,36667,194,533,26146,14189,77002,403702,243383,,,-99,-18,-117,311,10,329,533,13058
2020-02-24T18:00:00,ITA,4,P.A. Bolzano,46.49933453,11.35662422,0,0,0,0,0,0,0,0,0,0,1,null,,,0,0,0,0,0,0,0,0
2020-02-24T18:00:00,ITA,4,P.A. Trento,46.06893511,11.12123097,0,0,0,0,0,0,0,0,0,0,3,null,,,0,0,0,0,0,0,0,0
2020-02-25T18:00:00,ITA,4,P.A. Bolzano,46.49933453,11.35662422,1,0,1,0,1,1,1,0,0,1,1,null,,,0,0,0,0,0,0,0,0
2020-02-25T18:00:00,ITA,4,P.A. Trento,46.06893511,11.12123097,0,0,0,0,0,0,0,0,0,0,3,null,,,0,0,0,0,0,0,0,0
2020-02-26T18:00:00,ITA,4,P.A. Bolzano,46.49933453,11.35662422,1,0,1,0,1,0,0,0,0,1,1,null,,,0,0,0,0,0,0,0,0
2020-02-26T18:00:00,ITA,4,P.A. Trento,46.06893511,11.12123097,0,0,0,0,0,0,0,0,0,0,3,null,,,0,0,0,0,0,0,0,0
2020-02-27T18:00:00,ITA,4,P.A. Bolzano,46.49933453,11.35662422,1,0,1,0,1,0,0,0,0,1,2,null,,,0,0,0,0,0,0,0,0
2020-02-27T18:00:00,ITA,4,P.A. Trento,46.06893511,11.12123097,0,0,0,0,0,0,0,0,0,0,32,null,,,0,0,0,0,0,0,0,0
2020-02-28T18:00:00,ITA,4,P.A. Bolzano,46.49933453,11.35662422,1,0,1,0,1,0,0,0,0,1,2,null,,,0,0,0,0,0,0,0,0
2020-02-28T18:00:00,ITA,4,P.A. Trento,46.06893511,11.12123097,0,0,0,0,0,0,0,0,0,0,32,null,,,0,0,0,0,0,0,0,0
2020-02-29T17:00:00,ITA,4,P.A. Bolzano,46.49933453,11.35662422,1,0,1,0,1,0,0,0,0,1,16,null,,,0,0,0,0,0,0,0,0
2020-02-29T17:00:00,ITA,4,P.A. Trento,46.06893511,11.12123097,0,0,0,0,0,0,0,0,0,0,43,null,,,0,0,0,0,0,0,0,0
2020-03-01T17:00:00,ITA,4,P.A. Bolzano,46.49933453,11.35662422,1,0,1,0,1,0,0,0,0,1,20,null,,,0,0,0,0,0,0,0,0
2020-03-01T17:00:00,ITA,4,P.A. Trento,46.06893511,11.12123097,0,0,0,0,0,0,0,0,0,0,122,null,,,0,0,0,0,0,0,0,0
2020-03-02T18:00:00,ITA,4,P.A. Bolzano,46.49933453,11.35662422,1,0,1,0,1,0,0,0,0,1,20,null,,,0,0,0,0,0,0,0,0
2020-03-02T18:00:00,ITA,4,P.A. Trento,46.06893511,11.12123097,0,0,0,0,0,0,0,0,0,0,122,null,,,0,0,0,0,0,0,0,0
2020-03-03T18:00:00,ITA,4,P.A. Bolzano,46.49933453,11.35662422,1,0,1,0,1,0,0,0,0,1,20,null,,,0,0,0,0,0,0,0,0
2020-03-03T18:00:00,ITA,4,P.A. Trento,46.06893511,11.12123097,1,0,1,3,4,4,4,0,0,4,122,null,,,0,0,0,0,0,0,0,0
2020-03-04T17:00:00,ITA,4,P.A. Bolzano,46.49933453,11.35662422,1,0,1,0,1,0,0,0,0,1,20,null,,,0,0,0,0,0,0,0,0
2020-03-04T17:00:00,ITA,4,P.A. Trento,46.06893511,11.12123097,1,0,1,4,5,1,1,0,0,5,122,null,,,0,0,0,0,0,0,0,0
2020-03-05T17:00:00,ITA,4,P.A. Bolzano,46.49933453,11.35662422,1,0,1,0,1,0,0,0,0,1,20,null,,,0,0,0,0,0,0,0,0
2020-03-05T17:00:00,ITA,4,P.A. Trento,46.06893511,11.12123097,2,0,2,5,7,2,2,0,0,7,122,null,,,0,0,0,0,0,0,0,0
2020-03-06T17:00:00,ITA,4,P.A. Bolzano,46.49933453,11.35662422,4,0,4,0,4,3,3,0,0,4,36,null,,,0,0,0,0,0,0,0,0
2020-03-06T17:00:00,ITA,4,P.A. Trento,46.06893511,11.12123097,4,0,4,6,10,3,3,0,0,10,122,null,,,0,0,0,0,0,0,0,0
2020-03-07T18:00:00,ITA,4,P.A. Bolzano,46.49933453,11.35662422,8,0,8,1,9,5,5,0,0,9,36,null,,,0,0,0,0,0,0,0,0
2020-03-07T18:00:00,ITA,4,P.A. Trento,46.06893511,11.12123097,6,1,7,7,14,4,4,0,0,14,194,null,,,0,0,0,0,0,0,0,0
2020-03-08T18:00:00,ITA,4,P.A. Bolzano,46.49933453,11.35662422,8,0,8,1,9,0,0,0,0,9,36,null,,,0,0,0,0,0,0,0,0
2020-03-08T18:00:00,ITA,4,P.A. Trento,46.06893511,11.12123097,7,2,9,14,23,9,9,0,0,23,228,null,,,0,0,0,0,0,0,0,0
2020-03-09T18:00:00,ITA,4,P.A. Bolzano,46.49933453,11.35662422,8,0,8,1,9,0,0,0,0,9,36,null,,,0,0,0,0,0,0,0,0
2020-03-09T18:00:00,ITA,4,P.A. Trento,46.06893511,11.12123097,10,2,12,21,33,10,10,0,0,33,267,null,,,0,0,0,0,0,0,0,0
2020-03-10T18:00:00,ITA,4,P.A. Bolzano,46.49933453,11.35662422,17,1,18,20,38,29,29,0,0,38,36,null,,,0,0,0,0,0,0,0,0
2020-03-10T18:00:00,ITA,4,P.A. Trento,46.06893511,11.12123097,19,3,22,28,50,17,19,2,0,52,399,null,,,0,0,0,0,0,0,0,0
2020-03-11T17:00:00,ITA,4,P.A. Bolzano,46.49933453,11.35662422,8,4,12,63,75,37,37,0,0,75,75,null,,,0,0,0,0,0,0,0,0
2020-03-11T17:00:00,ITA,4,P.A. Trento,46.06893511,11.12123097,28,4,32,42,74,24,25,3,0,77,527,null,,,0,0,0,0,0,0,0,0
2020-03-12T17:00:00,ITA,4,P.A. Bolzano,46.49933453,11.35662422,21,4,25,78,103,28,29,0,1,104,607,null,,,0,0,0,0,0,0,0,0
2020-03-12T17:00:00,ITA,4,P.A. Trento,46.06893511,11.12123097,43,5,48,54,102,28,30,4,1,107,593,null,,,0,0,0,0,0,0,0,0
2020-03-13T17:00:00,ITA,4,P.A. Bolzano,46.49933453,11.35662422,20,5,25,98,123,20,21,0,2,125,811,null,,,0,0,0,0,0,0,0,0
2020-03-13T17:00:00,ITA,4,P.A. Trento,46.06893511,11.12123097,58,6,64,93,157,55,56,4,2,163,846,null,,,0,0,0,0,0,0,0,0
2020-03-14T17:00:00,ITA,4,P.A. Bolzano,46.49933453,11.35662422,26,7,33,137,170,47,48,0,3,173,1135,null,,,0,0,0,0,0,0,0,0
2020-03-14T17:00:00,ITA,4,P.A. Trento,46.06893511,11.12123097,68,12,80,119,199,42,43,5,2,206,1006,null,,,0,0,0,0,0,0,0,0
2020-03-15T17:00:00,ITA,4,P.A. Bolzano,46.49933453,11.35662422,50,4,54,145,199,29,31,0,5,204,1497,null,,,0,0,0,0,0,0,0,0
2020-03-15T17:00:00,ITA,4,P.A. Trento,46.06893511,11.12123097,73,19,92,275,367,168,172,5,6,378,1006,null,,,0,0,0,0,0,0,0,0
2020-03-16T17:00:00,ITA,4,P.A. Bolzano,46.49933453,11.35662422,53,11,64,171,235,36,37,0,6,241,1740,null,,,0,0,0,0,0,0,0,0
2020-03-16T17:00:00,ITA,4,P.A. Trento,46.06893511,11.12123097,73,19,92,275,367,0,0,5,6,378,1006,null,nd-IT-0003,nd-EN-0003,0,0,0,0,0,0,0,0
2020-03-17T17:00:00,ITA,4,P.A. Bolzano,46.49933453,11.35662422,71,11,82,200,282,47,50,1,8,291,2149,null,,,0,0,0,0,0,0,0,0
2020-03-17T17:00:00,ITA,4,P.A. Trento,46.06893511,11.12123097,107,22,129,239,368,1,7,10,7,385,1727,null,,,0,0,0,0,0,0,0,0
2020-03-18T17:00:00,ITA,4,P.A. Bolzano,46.49933453,11.35662422,79,18,97,269,366,84,85,1,9,376,2844,null,,,0,0,0,0,0,0,0,0
2020-03-18T17:00:00,ITA,4,P.A. Trento,46.06893511,11.12123097,141,22,163,273,436,68,70,12,7,455,2187,null,,,0,0,0,0,0,0,0,0
2020-03-19T17:00:00,ITA,4,P.A. Bolzano,46.49933453,11.35662422,87,18,105,316,421,55,60,1,14,436,3568,null,,,0,0,0,0,0,0,0,0
2020-03-19T17:00:00,ITA,4,P.A. Trento,46.06893511,11.12123097,169,30,199,292,491,55,68,20,12,523,2203,null,,,0,0,0,0,0,0,0,0
2020-03-20T17:00:00,ITA,4,P.A. Bolzano,46.49933453,11.35662422,99,24,123,407,530,109,112,1,17,548,4433,null,,,0,0,0,0,0,0,0,0
2020-03-20T17:00:00,ITA,4,P.A. Trento,46.06893511,11.12123097,198,34,232,368,600,109,119,29,13,642,2656,null,,,0,0,0,0,0,0,0,0
2020-03-21T17:00:00,ITA,4,P.A. Bolzano,46.49933453,11.35662422,127,30,157,443,600,70,73,1,20,621,5179,null,,,0,0,0,0,0,0,0,0
2020-03-21T17:00:00,ITA,4,P.A. Trento,46.06893511,11.12123097,233,39,272,448,720,120,140,34,28,782,2656,null,,,0,0,0,0,0,0,0,0
2020-03-22T17:00:00,ITA,4,P.A. Bolzano,46.49933453,11.35662422,146,32,178,470,648,48,57,7,23,678,5718,null,,,0,0,0,0,0,0,0,0
2020-03-22T17:00:00,ITA,4,P.A. Trento,46.06893511,11.12123097,235,46,281,604,885,165,172,34,35,954,3050,null,,,0,0,0,0,0,0,0,0
2020-03-23T17:00:00,ITA,4,P.A. Bolzano,46.49933453,11.35662422,145,33,178,510,688,40,46,7,29,724,6084,null,,,0,0,0,0,0,0,0,0
2020-03-23T17:00:00,ITA,4,P.A. Trento,46.06893511,11.12123097,249,46,295,619,914,29,69,68,41,1023,3150,null,,,0,0,0,0,0,0,0,0
2020-03-24T17:00:00,ITA,4,P.A. Bolzano,46.49933453,11.35662422,166,38,204,495,699,11,57,44,38,781,6509,null,,,0,0,0,0,0,0,0,0
2020-03-24T17:00:00,ITA,4,P.A. Trento,46.06893511,11.12123097,308,49,357,618,975,61,87,79,56,1110,3712,null,,,0,0,0,0,0,0,0,0
2020-03-25T17:00:00,ITA,4,P.A. Bolzano,46.49933453,11.35662422,190,40,230,518,748,49,77,67,43,858,6649,null,,,0,0,0,0,0,0,0,0
2020-03-25T17:00:00,ITA,4,P.A. Trento,46.06893511,11.12123097,308,65,373,685,1058,83,112,90,74,1222,4114,null,,,0,0,0,0,0,0,0,0
2020-03-26T17:00:00,ITA,4,P.A. Bolzano,46.49933453,11.35662422,223,43,266,525,791,43,48,67,48,906,7744,null,,,0,0,0,0,0,0,0,0
2020-03-26T17:00:00,ITA,4,P.A. Trento,46.06893511,11.12123097,300,66,366,728,1094,36,75,117,86,1297,4600,null,,,0,0,0,0,0,0,0,0
2020-03-27T17:00:00,ITA,4,P.A. Bolzano,46.49933453,11.35662422,249,45,294,539,833,42,97,110,60,1003,8520,null,,,0,0,0,0,0,0,0,0
2020-03-27T17:00:00,ITA,4,P.A. Trento,46.06893511,11.12123097,341,66,407,757,1164,70,94,125,102,1391,4923,null,,,0,0,0,0,0,0,0,0
2020-03-28T17:00:00,ITA,4,P.A. Bolzano,46.49933453,11.35662422,225,51,276,653,929,96,106,116,64,1109,9168,null,,,0,0,0,0,0,0,0,0
2020-03-28T17:00:00,ITA,4,P.A. Trento,46.06893511,11.12123097,351,72,423,811,1234,70,114,151,120,1505,5561,null,,,0,0,0,0,0,0,0,0
2020-03-29T17:00:00,ITA,4,P.A. Bolzano,46.49933453,11.35662422,234,56,290,744,1034,105,105,116,64,1214,10137,null,,,0,0,0,0,0,0,0,0
2020-03-29T17:00:00,ITA,4,P.A. Trento,46.06893511,11.12123097,356,75,431,862,1293,59,89,172,129,1594,5950,null,,,0,0,0,0,0,0,0,0
2020-03-30T17:00:00,ITA,4,P.A. Bolzano,46.49933453,11.35662422,231,62,293,805,1098,64,111,153,74,1325,10640,null,,,0,0,0,0,0,0,0,0
2020-03-30T17:00:00,ITA,4,P.A. Trento,46.06893511,11.12123097,353,78,431,926,1357,64,88,178,147,1682,6377,null,,,0,0,0,0,0,0,0,0
2020-03-31T17:00:00,ITA,4,P.A. Bolzano,46.49933453,11.35662422,249,62,311,831,1142,44,46,153,76,1371,11275,null,,,0,0,0,0,0,0,0,0
2020-03-31T17:00:00,ITA,4,P.A. Trento,46.06893511,11.12123097,354,80,434,955,1389,32,64,193,164,1746,6973,null,,,0,0,0,0,0,0,0,0
2020-04-01T17:00:00,ITA,4,P.A. Bolzano,46.49933453,11.35662422,269,57,326,786,1112,-30,47,190,116,1418,11951,null,,,0,0,0,0,0,0,0,0
2020-04-01T17:00:00,ITA,4,P.A. Trento,46.06893511,11.12123097,345,76,421,1062,1483,94,124,214,173,1870,7675,null,,,0,0,0,0,0,0,0,0
2020-04-02T17:00:00,ITA,4,P.A. Bolzano,46.49933453,11.35662422,279,60,339,821,1160,48,61,190,129,1479,12677,null,,,0,0,0,0,0,0,0,0
2020-04-02T17:00:00,ITA,4,P.A. Trento,46.06893511,11.12123097,339,78,417,1170,1587,104,133,229,187,2003,8496,null,,,0,0,0,0,0,0,0,0
2020-04-03T17:00:00,ITA,4,P.A. Bolzano,46.49933453,11.35662422,291,60,351,858,1209,49,80,211,139,1559,13976,null,,,0,0,0,0,0,0,0,0
2020-04-03T17:00:00,ITA,4,P.A. Trento,46.06893511,11.12123097,343,80,423,1236,1659,72,106,246,204,2109,8993,null,,,0,0,0,0,0,0,0,0
2020-04-04T17:00:00,ITA,4,P.A. Bolzano,46.49933453,11.35662422,291,61,352,849,1201,-8,33,245,146,1592,15045,null,,,0,0,0,0,0,0,0,0
2020-04-04T17:00:00,ITA,4,P.A. Trento,46.06893511,11.12123097,353,81,434,1319,1753,94,111,257,210,2220,9863,null,,,0,0,0,0,0,0,0,0
2020-04-05T17:00:00,ITA,4,P.A. Bolzano,46.49933453,11.35662422,239,53,292,934,1226,25,52,260,158,1644,15723,null,,,0,0,0,0,0,0,0,0
2020-04-05T17:00:00,ITA,4,P.A. Trento,46.06893511,11.12123097,352,80,432,1363,1795,42,65,273,217,2285,10476,null,,,0,0,0,0,0,0,0,0
2020-04-06T17:00:00,ITA,4,P.A. Bolzano,46.49933453,11.35662422,245,52,297,963,1260,34,78,298,164,1722,16825,null,,,0,0,0,0,0,0,0,0
2020-04-06T17:00:00,ITA,4,P.A. Trento,46.06893511,11.12123097,354,79,433,1405,1838,43,63,280,230,2348,11130,null,,,0,0,0,0,0,0,0,0
2020-04-07T17:00:00,ITA,4,P.A. Bolzano,46.49933453,11.35662422,325,64,389,912,1301,41,89,336,174,1811,17761,null,,,0,0,0,0,0,0,0,0
2020-04-07T17:00:00,ITA,4,P.A. Trento,46.06893511,11.12123097,360,78,438,1452,1890,52,128,342,244,2476,12030,null,,,0,0,0,0,0,0,0,0
2020-04-08T17:00:00,ITA,4,P.A. Bolzano,46.49933453,11.35662422,268,65,333,948,1281,-20,24,371,183,1835,18865,null,,,0,0,0,0,0,0,0,0
2020-04-08T17:00:00,ITA,4,P.A. Trento,46.06893511,11.12123097,354,77,431,1509,1940,50,126,407,255,2602,13258,null,,,0,0,0,0,0,0,0,0
2020-04-09T17:00:00,ITA,4,P.A. Bolzano,46.49933453,11.35662422,263,64,327,988,1315,34,68,401,187,1903,19875,null,,,0,0,0,0,0,0,0,0
2020-04-09T17:00:00,ITA,4,P.A. Trento,46.06893511,11.12123097,345,69,414,1564,1978,38,106,462,268,2708,14338,null,,,0,0,0,0,0,0,0,0
2020-04-10T17:00:00,ITA,4,P.A. Bolzano,46.49933453,11.35662422,258,58,316,1001,1317,2,52,447,191,1955,20866,null,,,0,0,0,0,0,0,0,0
2020-04-10T17:00:00,ITA,4,P.A. Trento,46.06893511,11.12123097,335,70,405,1589,1994,16,108,547,275,2816,14981,null,,,0,0,0,0,0,0,0,0
2020-04-11T17:00:00,ITA,4,P.A. Bolzano,46.49933453,11.35662422,246,56,302,967,1269,-48,2,488,200,1957,22186,null,,,0,0,0,0,0,0,0,0
2020-04-11T17:00:00,ITA,4,P.A. Trento,46.06893511,11.12123097,335,62,397,1667,2064,70,154,622,284,2970,16646,null,,,0,0,0,0,0,0,0,0
2020-04-12T17:00:00,ITA,4,P.A. Bolzano,46.49933453,11.35662422,183,45,228,1287,1515,246,141,378,205,2098,23246,null,dc-IT-0002,dc-EN-0002,0,0,0,0,0,0,0,0
2020-04-12T17:00:00,ITA,4,P.A. Trento,46.06893511,11.12123097,322,61,383,1699,2082,18,83,678,293,3053,17797,null,,,0,0,0,0,0,0,0,0
2020-04-13T17:00:00,ITA,4,P.A. Bolzano,46.49933453,11.35662422,190,41,231,1306,1537,22,51,400,212,2149,24157,null,,,0,0,0,0,0,0,0,0
2020-04-13T17:00:00,ITA,4,P.A. Trento,46.06893511,11.12123097,326,56,382,1698,2080,-2,73,746,300,3126,18586,null,,,0,0,0,0,0,0,0,0
2020-04-14T17:00:00,ITA,4,P.A. Bolzano,46.49933453,11.35662422,177,39,216,1348,1564,27,35,406,214,2184,24457,null,,,0,0,0,0,0,0,0,0
2020-04-14T17:00:00,ITA,4,P.A. Trento,46.06893511,11.12123097,325,54,379,1703,2082,2,15,749,310,3141,18774,null,,,0,0,0,0,0,0,0,0
2020-04-15T17:00:00,ITA,4,P.A. Bolzano,46.49933453,11.35662422,166,32,198,1378,1576,12,40,425,223,2224,25370,null,,,0,0,0,0,0,0,0,0
2020-04-15T17:00:00,ITA,4,P.A. Trento,46.06893511,11.12123097,312,48,360,1744,2104,22,79,798,318,3220,19535,null,,,0,0,0,0,0,0,0,0
2020-04-16T17:00:00,ITA,4,P.A. Bolzano,46.49933453,11.35662422,180,34,214,1379,1593,17,43,449,225,2267,26416,null,,,0,0,0,0,0,0,0,0
2020-04-16T17:00:00,ITA,4,P.A. Trento,46.06893511,11.12123097,296,43,339,1748,2087,-17,74,885,322,3294,20773,null,,,0,0,0,0,0,0,0,0
2020-04-17T17:00:00,ITA,4,P.A. Bolzano,46.49933453,11.35662422,181,32,213,1369,1582,-11,29,480,234,2296,27698,null,,,0,0,0,0,0,0,0,0
2020-04-17T17:00:00,ITA,4,P.A. Trento,46.06893511,11.12123097,286,44,330,1660,1990,-97,82,1044,342,3376,21921,null,,,0,0,0,0,0,0,0,0
2020-04-18T17:00:00,ITA,4,P.A. Bolzano,46.49933453,11.35662422,179,28,207,1349,1556,-26,29,530,239,2325,28888,null,,,0,0,0,0,0,0,0,0
2020-04-18T17:00:00,ITA,4,P.A. Trento,46.06893511,11.12123097,276,42,318,1667,1985,-5,55,1098,348,3431,23147,null,,,0,0,0,0,0,0,0,0
2020-04-19T17:00:00,ITA,4,P.A. Bolzano,46.49933453,11.35662422,162,23,185,1381,1566,10,55,569,245,2380,30361,14783,,,0,0,0,0,0,0,0,0
2020-04-19T17:00:00,ITA,4,P.A. Trento,46.06893511,11.12123097,278,41,319,1652,1971,-14,101,1201,360,3532,24388,16685,,,0,0,0,0,0,0,0,0
2020-04-20T17:00:00,ITA,4,P.A. Bolzano,46.49933453,11.35662422,160,19,179,1361,1540,-26,14,605,249,2394,31381,15089,,,0,0,0,0,0,0,0,0
2020-04-20T17:00:00,ITA,4,P.A. Trento,46.06893511,11.12123097,272,40,312,1617,1929,-42,58,1295,366,3590,26211,17347,,,0,0,0,0,0,0,0,0
2020-04-21T17:00:00,ITA,4,P.A. Bolzano,46.49933453,11.35662422,159,20,179,1357,1536,-4,16,623,251,2410,31987,15405,,,0,0,0,0,0,0,0,0
2020-04-21T17:00:00,ITA,4,P.A. Trento,46.06893511,11.12123097,254,38,292,1617,1909,-20,24,1329,376,3614,26610,17705,,,0,0,0,0,0,0,0,0
2020-04-22T17:00:00,ITA,4,P.A. Bolzano,46.49933453,11.35662422,157,19,176,1336,1512,-24,6,648,256,2416,32722,15736,,,0,0,0,0,0,0,0,0
2020-04-22T17:00:00,ITA,4,P.A. Trento,46.06893511,11.12123097,245,34,279,1595,1874,-35,32,1391,381,3646,26674,17672,,,0,0,0,0,0,0,0,0
2020-04-23T17:00:00,ITA,4,P.A. Bolzano,46.49933453,11.35662422,141,17,158,1336,1494,-18,19,680,261,2435,33994,16442,,,0,0,0,0,0,0,0,0
2020-04-23T17:00:00,ITA,4,P.A. Trento,46.06893511,11.12123097,234,29,263,1608,1871,-3,81,1474,382,3727,28240,18656,,,0,0,0,0,0,0,0,0
2020-04-24T17:00:00,ITA,4,P.A. Bolzano,46.49933453,11.35662422,148,16,164,929,1093,-401,21,1100,263,2456,35062,17024,,,0,0,0,0,0,0,0,0
2020-04-24T17:00:00,ITA,4,P.A. Trento,46.06893511,11.12123097,224,28,252,1575,1827,-44,49,1560,389,3776,29779,19250,,,0,0,0,0,0,0,0,0
2020-04-25T17:00:00,ITA,4,P.A. Bolzano,46.49933453,11.35662422,141,14,155,880,1035,-58,20,1176,265,2476,36608,17573,,,0,0,0,0,0,0,0,0
2020-04-25T17:00:00,ITA,4,P.A. Trento,46.06893511,11.12123097,202,27,229,1515,1744,-83,62,1694,400,3838,30661,19394,,,0,0,0,0,0,0,0,0
2020-04-26T17:00:00,ITA,4,P.A. Bolzano,46.49933453,11.35662422,138,14,152,842,994,-41,5,1218,269,2481,37431,17895,,,0,0,0,0,0,0,0,0
2020-04-26T17:00:00,ITA,4,P.A. Trento,46.06893511,11.12123097,199,24,223,1459,1682,-62,56,1807,405,3894,32142,19902,,,0,0,0,0,0,0,0,0
2020-04-27T17:00:00,ITA,4,P.A. Bolzano,46.49933453,11.35662422,150,16,166,774,940,-54,15,1286,270,2496,38640,18423,,,0,0,0,0,0,0,0,0
2020-04-27T17:00:00,ITA,4,P.A. Trento,46.06893511,11.12123097,201,23,224,1483,1707,25,101,1881,407,3995,33152,20199,,,0,0,0,0,0,0,0,0
2020-04-28T17:00:00,ITA,4,P.A. Bolzano,46.49933453,11.35662422,136,15,151,759,910,-30,2,1316,272,2498,39130,18567,,,0,0,0,0,0,0,0,0
2020-04-28T17:00:00,ITA,4,P.A. Trento,46.06893511,11.12123097,182,22,204,1361,1565,-142,30,2048,412,4025,33839,20539,,,0,0,0,0,0,0,0,0
2020-04-29T17:00:00,ITA,4,P.A. Bolzano,46.49933453,11.35662422,119,14,133,712,845,-65,9,1388,274,2507,40218,18844,,,0,0,0,0,0,0,0,0
2020-04-29T17:00:00,ITA,4,P.A. Trento,46.06893511,11.12123097,165,22,187,1276,1463,-102,44,2190,416,4069,35008,20944,,,0,0,0,0,0,0,0,0
2020-04-30T17:00:00,ITA,4,P.A. Bolzano,46.49933453,11.35662422,126,13,139,663,802,-43,11,1441,275,2518,41297,19178,,,0,0,0,0,0,0,0,0
2020-04-30T17:00:00,ITA,4,P.A. Trento,46.06893511,11.12123097,158,21,179,1191,1370,-93,47,2328,418,4116,36534,21622,,,0,0,0,0,0,0,0,0
2020-05-01T17:00:00,ITA,4,P.A. Bolzano,46.49933453,11.35662422,112,11,123,634,757,-45,10,1493,278,2528,42903,19705,,,0,0,0,0,0,0,0,0
2020-05-01T17:00:00,ITA,4,P.A. Trento,46.06893511,11.12123097,146,19,165,1128,1293,-77,16,2416,423,4132,37838,22602,,,0,0,0,0,0,0,0,0
2020-05-02T17:00:00,ITA,4,P.A. Bolzano,46.49933453,11.35662422,113,10,123,580,703,-54,7,1553,279,2535,43804,20036,,,0,0,0,0,0,0,0,0
2020-05-02T17:00:00,ITA,4,P.A. Trento,46.06893511,11.12123097,138,19,157,1125,1282,-11,49,2474,425,4181,39579,23380,,,0,0,0,0,0,0,0,0
2020-02-24T18:00:00,ITA,5,Veneto,45.43490485,12.33845213,12,4,16,16,32,0,32,0,1,33,2200,null,,,0,0,0,0,0,0,0,0
2020-02-25T18:00:00,ITA,5,Veneto,45.43490485,12.33845213,12,7,19,23,42,10,10,0,1,43,3780,null,,,12,7,19,23,0,1,43,3780
2020-02-26T18:00:00,ITA,5,Veneto,45.43490485,12.33845213,16,8,24,45,69,27,28,0,2,71,4900,null,,,4,1,5,22,0,1,28,1120
2020-02-27T18:00:00,ITA,5,Veneto,45.43490485,12.33845213,19,8,27,82,109,40,40,0,2,111,6164,null,,,3,0,3,37,0,0,40,1264
2020-02-28T18:00:00,ITA,5,Veneto,45.43490485,12.33845213,24,9,33,116,149,40,40,0,2,151,7414,null,,,5,1,6,34,0,0,40,1250
2020-02-29T17:00:00,ITA,5,Veneto,45.43490485,12.33845213,24,11,35,154,189,40,40,0,2,191,8659,null,,,0,2,2,38,0,0,40,1245
2020-03-01T17:00:00,ITA,5,Veneto,45.43490485,12.33845213,51,13,64,197,261,72,72,0,2,263,9056,null,,,27,2,29,43,0,0,72,397
2020-03-02T18:00:00,ITA,5,Veneto,45.43490485,12.33845213,53,14,67,204,271,10,10,0,2,273,9782,null,,,2,1,3,7,0,0,10,726
2020-03-03T18:00:00,ITA,5,Veneto,45.43490485,12.33845213,49,19,68,229,297,26,34,7,3,307,10176,null,,,-4,5,1,25,7,1,34,394
2020-03-04T17:00:00,ITA,5,Veneto,45.43490485,12.33845213,76,23,99,246,345,48,53,9,6,360,10515,null,,,27,4,31,17,2,3,53,339
2020-03-05T17:00:00,ITA,5,Veneto,45.43490485,12.33845213,92,24,116,264,380,35,47,17,10,407,11949,null,,,16,1,17,18,8,4,47,1434
2020-03-06T17:00:00,ITA,5,Veneto,45.43490485,12.33845213,117,27,144,310,454,74,81,22,12,488,13023,null,,,25,3,28,46,5,2,81,1074
2020-03-07T18:00:00,ITA,5,Veneto,45.43490485,12.33845213,123,41,164,341,505,51,55,25,13,543,14429,null,,,6,14,20,31,3,1,55,1406
2020-03-08T18:00:00,ITA,5,Veneto,45.43490485,12.33845213,146,47,193,430,623,118,127,29,18,670,15918,null,,,23,6,29,89,4,5,127,1489
2020-03-09T18:00:00,ITA,5,Veneto,45.43490485,12.33845213,186,51,237,457,694,71,74,30,20,744,15956,null,,,40,4,44,27,1,2,74,38
2020-03-10T18:00:00,ITA,5,Veneto,45.43490485,12.33845213,204,67,271,512,783,89,112,47,26,856,16643,null,,,18,16,34,55,17,6,112,687
2020-03-11T17:00:00,ITA,5,Veneto,45.43490485,12.33845213,262,68,330,610,940,157,167,54,29,1023,21400,null,,,58,1,59,98,7,3,167,4757
2020-03-12T17:00:00,ITA,5,Veneto,45.43490485,12.33845213,360,85,445,852,1297,357,361,55,32,1384,23438,null,,,98,17,115,242,1,3,361,2038
2020-03-13T17:00:00,ITA,5,Veneto,45.43490485,12.33845213,366,107,473,980,1453,156,211,100,42,1595,25691,null,,,6,22,28,128,45,10,211,2253
2020-03-14T17:00:00,ITA,5,Veneto,45.43490485,12.33845213,366,119,485,1290,1775,322,342,107,55,1937,26980,null,,,0,12,12,310,7,13,342,1289
2020-03-15T17:00:00,ITA,5,Veneto,45.43490485,12.33845213,426,129,555,1434,1989,214,235,120,63,2172,32546,null,,,60,10,70,144,13,8,235,5566
2020-03-16T17:00:00,ITA,5,Veneto,45.43490485,12.33845213,498,156,654,1620,2274,285,301,130,69,2473,35052,null,,,72,27,99,186,10,6,301,2506
2020-03-17T17:00:00,ITA,5,Veneto,45.43490485,12.33845213,548,171,719,1769,2488,214,231,136,80,2704,35478,null,,,50,15,65,149,6,11,231,426
2020-03-18T17:00:00,ITA,5,Veneto,45.43490485,12.33845213,646,195,841,2112,2953,465,510,167,94,3214,40841,null,,,98,24,122,343,31,14,510,5363
2020-03-19T17:00:00,ITA,5,Veneto,45.43490485,12.33845213,771,209,980,2189,3169,216,270,200,115,3484,44658,null,,,125,14,139,77,33,21,270,3817
2020-03-20T17:00:00,ITA,5,Veneto,45.43490485,12.33845213,843,236,1079,2598,3677,508,547,223,131,4031,49288,null,,,72,27,99,409,23,16,547,4630
2020-03-21T17:00:00,ITA,5,Veneto,45.43490485,12.33845213,942,249,1191,3023,4214,537,586,257,146,4617,53642,null,,,99,13,112,425,34,15,586,4354
2020-03-22T17:00:00,ITA,5,Veneto,45.43490485,12.33845213,1113,255,1368,3276,4644,430,505,309,169,5122,57671,null,,,171,6,177,253,52,23,505,4029
2020-03-23T17:00:00,ITA,5,Veneto,45.43490485,12.33845213,1206,281,1487,3499,4986,342,383,327,192,5505,61115,null,,,93,26,119,223,18,23,383,3444
2020-03-24T17:00:00,ITA,5,Veneto,45.43490485,12.33845213,1318,304,1622,3729,5351,365,443,381,216,5948,66178,null,,,112,23,135,230,54,24,443,5063
2020-03-25T17:00:00,ITA,5,Veneto,45.43490485,12.33845213,1407,316,1723,4022,5745,394,494,439,258,6442,70877,null,,,89,12,101,293,58,42,494,4699
2020-03-26T17:00:00,ITA,5,Veneto,45.43490485,12.33845213,1447,326,1773,4367,6140,395,493,508,287,6935,79759,null,,,40,10,50,345,69,29,493,8882
2020-03-27T17:00:00,ITA,5,Veneto,45.43490485,12.33845213,1536,338,1874,4774,6648,508,562,536,313,7497,83627,null,,,89,12,101,407,28,26,562,3868
2020-03-28T17:00:00,ITA,5,Veneto,45.43490485,12.33845213,1559,344,1903,5010,6913,265,433,655,362,7930,89380,null,,,23,6,29,236,119,49,433,5753
2020-03-29T17:00:00,ITA,5,Veneto,45.43490485,12.33845213,1586,355,1941,5310,7251,338,428,715,392,8358,94784,null,,,27,11,38,300,60,30,428,5404
2020-03-30T17:00:00,ITA,5,Veneto,45.43490485,12.33845213,1633,356,1989,5575,7564,313,366,747,413,8724,99941,null,,,47,1,48,265,32,21,366,5157
2020-03-31T17:00:00,ITA,5,Veneto,45.43490485,12.33845213,1680,356,2036,5814,7850,286,431,828,477,9155,106238,null,,,47,0,47,239,81,64,431,6297
2020-04-01T17:00:00,ITA,5,Veneto,45.43490485,12.33845213,1718,350,2068,6156,8224,374,470,902,499,9625,112746,null,,,38,-6,32,342,74,22,470,6508
2020-04-02T17:00:00,ITA,5,Veneto,45.43490485,12.33845213,1670,345,2015,6563,8578,354,486,1001,532,10111,120320,null,,,-48,-5,-53,407,99,33,486,7574
2020-04-03T17:00:00,ITA,5,Veneto,45.43490485,12.33845213,1714,335,2049,6812,8861,283,353,1031,572,10464,126490,null,,,44,-10,34,249,30,40,353,6170
2020-04-04T17:00:00,ITA,5,Veneto,45.43490485,12.33845213,1691,324,2015,7078,9093,232,360,1124,607,10824,133289,null,,,-23,-11,-34,266,93,35,360,6799
2020-04-05T17:00:00,ITA,5,Veneto,45.43490485,12.33845213,1674,329,2003,7406,9409,316,402,1186,631,11226,140910,null,,,-17,5,-12,328,62,24,402,7621
2020-04-06T17:00:00,ITA,5,Veneto,45.43490485,12.33845213,1714,322,2036,7686,9722,313,362,1204,662,11588,146288,null,,,40,-7,33,280,18,31,362,5378
2020-04-07T17:00:00,ITA,5,Veneto,45.43490485,12.33845213,1579,297,1876,8089,9965,243,337,1265,695,11925,153542,null,,,-135,-25,-160,403,61,33,337,7254
2020-04-08T17:00:00,ITA,5,Veneto,45.43490485,12.33845213,1554,285,1839,8332,10171,206,485,1503,736,12410,163247,null,,,-25,-12,-37,243,238,41,485,9705
2020-04-09T17:00:00,ITA,5,Veneto,45.43490485,12.33845213,1530,274,1804,8645,10449,278,523,1728,756,12933,171456,null,,,-24,-11,-35,313,225,20,523,8209
2020-04-10T17:00:00,ITA,5,Veneto,45.43490485,12.33845213,1521,257,1778,8869,10647,198,488,1981,793,13421,180700,null,,,-9,-17,-26,224,253,37,488,9244
2020-04-11T17:00:00,ITA,5,Veneto,45.43490485,12.33845213,1465,251,1716,9033,10749,102,347,2188,831,13768,190912,null,,,-56,-6,-62,164,207,38,347,10212
2020-04-12T17:00:00,ITA,5,Veneto,45.43490485,12.33845213,1428,249,1677,9052,10729,-20,309,2492,856,14077,198442,null,,,-37,-2,-39,19,304,25,309,7530
2020-04-13T17:00:00,ITA,5,Veneto,45.43490485,12.33845213,1427,245,1672,9094,10766,37,174,2603,882,14251,203077,null,,,-1,-4,-5,42,111,26,174,4635
2020-04-14T17:00:00,ITA,5,Veneto,45.43490485,12.33845213,1427,233,1660,9076,10736,-30,181,2790,906,14432,208878,null,,,0,-12,-12,-18,187,24,181,5801
2020-04-15T17:00:00,ITA,5,Veneto,45.43490485,12.33845213,1402,219,1621,9168,10789,53,192,2895,940,14624,216344,null,,,-25,-14,-39,92,105,34,192,7466
2020-04-16T17:00:00,ITA,5,Veneto,45.43490485,12.33845213,1388,209,1597,9203,10800,11,366,3209,981,14990,224549,null,,,-14,-10,-24,35,314,41,366,8205
2020-04-17T17:00:00,ITA,5,Veneto,45.43490485,12.33845213,1359,197,1556,9062,10618,-182,384,3730,1026,15374,236722,null,,,-29,-12,-41,-141,521,45,384,12173
2020-04-18T17:00:00,ITA,5,Veneto,45.43490485,12.33845213,1287,190,1477,8967,10444,-174,318,4189,1059,15692,247329,null,,,-72,-7,-79,-95,459,33,318,10607
2020-04-19T17:00:00,ITA,5,Veneto,45.43490485,12.33845213,1264,184,1448,8762,10210,-234,243,4638,1087,15935,255797,161231,,,-23,-6,-29,-205,449,28,243,8468
2020-04-20T17:00:00,ITA,5,Veneto,45.43490485,12.33845213,1273,180,1453,8608,10061,-149,192,4954,1112,16127,260810,163757,,,9,-4,5,-154,316,25,192,5013
2020-04-21T17:00:00,ITA,5,Veneto,45.43490485,12.33845213,1230,177,1407,8670,10077,16,277,5173,1154,16404,268069,167129,,,-43,-3,-46,62,219,42,277,7259
2020-04-22T17:00:00,ITA,5,Veneto,45.43490485,12.33845213,1205,163,1368,8623,9991,-86,334,5566,1181,16738,277543,171735,,,-25,-14,-39,-47,393,27,334,9474
2020-04-23T17:00:00,ITA,5,Veneto,45.43490485,12.33845213,1189,140,1329,8596,9925,-66,143,5750,1206,16881,288075,177154,,,-16,-23,-39,-27,184,25,143,10532
2020-04-24T17:00:00,ITA,5,Veneto,45.43490485,12.33845213,1159,130,1289,8390,9679,-246,348,6306,1244,17229,296896,181473,,,-30,-10,-40,-206,556,38,348,8821
2020-04-25T17:00:00,ITA,5,Veneto,45.43490485,12.33845213,1105,129,1234,8198,9432,-247,162,6671,1288,17391,306977,186426,,,-54,-1,-55,-192,365,44,162,10081
2020-04-26T17:00:00,ITA,5,Veneto,45.43490485,12.33845213,1097,124,1221,7917,9138,-294,80,7018,1315,17471,316361,183513,,,-8,-5,-13,-281,347,27,80,9384
2020-04-27T17:00:00,ITA,5,Veneto,45.43490485,12.33845213,1099,123,1222,7638,8860,-278,108,7375,1344,17579,320027,192751,,,2,-1,1,-279,357,29,108,3666
2020-04-28T17:00:00,ITA,5,Veneto,45.43490485,12.33845213,1067,120,1187,7414,8601,-259,129,7699,1408,17708,328218,196864,,,-32,-3,-35,-224,324,64,129,8191
2020-04-29T17:00:00,ITA,5,Veneto,45.43490485,12.33845213,1042,114,1156,7213,8369,-232,117,8019,1437,17825,337656,200737,,,-25,-6,-31,-201,320,29,117,9438
2020-04-30T17:00:00,ITA,5,Veneto,45.43490485,12.33845213,1012,114,1126,7021,8147,-222,135,8354,1459,17960,349227,206347,,,-30,0,-30,-192,335,22,135,11571
2020-05-01T17:00:00,ITA,5,Veneto,45.43490485,12.33845213,977,110,1087,6692,7779,-368,138,8840,1479,18098,362459,212706,,,-35,-4,-39,-329,486,20,138,13232
2020-05-02T17:00:00,ITA,5,Veneto,45.43490485,12.33845213,970,108,1078,6353,7431,-348,126,9291,1502,18224,370978,216997,,,-7,-2,-9,-339,451,23,126,8519
2020-02-24T18:00:00,ITA,6,Friuli Venezia Giulia,45.6494354,13.76813649,0,0,0,0,0,0,0,0,0,0,58,null,,,0,0,0,0,0,0,0,0
2020-02-25T18:00:00,ITA,6,Friuli Venezia Giulia,45.6494354,13.76813649,0,0,0,0,0,0,0,0,0,0,89,null,,,0,0,0,0,0,0,0,89
2020-02-26T18:00:00,ITA,6,Friuli Venezia Giulia,45.6494354,13.76813649,0,0,0,0,0,0,0,0,0,0,114,null,,,0,0,0,0,0,0,0,25
2020-02-27T18:00:00,ITA,6,Friuli Venezia Giulia,45.6494354,13.76813649,0,0,0,0,0,0,0,0,0,0,141,null,,,0,0,0,0,0,0,0,27
2020-02-28T18:00:00,ITA,6,Friuli Venezia Giulia,45.6494354,13.76813649,0,0,0,0,0,0,0,0,0,0,169,null,,,0,0,0,0,0,0,0,28
2020-02-29T17:00:00,ITA,6,Friuli Venezia Giulia,45.6494354,13.76813649,0,0,0,0,0,0,0,0,0,0,189,null,,,0,0,0,0,0,0,0,20
2020-03-01T17:00:00,ITA,6,Friuli Venezia Giulia,45.6494354,13.76813649,0,0,0,6,6,6,6,0,0,6,243,null,,,0,0,0,6,0,0,6,54
2020-03-02T18:00:00,ITA,6,Friuli Venezia Giulia,45.6494354,13.76813649,0,0,0,9,9,3,3,0,0,9,269,null,,,0,0,0,3,0,0,3,26
2020-03-03T18:00:00,ITA,6,Friuli Venezia Giulia,45.6494354,13.76813649,1,0,1,12,13,4,4,0,0,13,354,null,,,1,0,1,3,0,0,4,85
2020-03-04T17:00:00,ITA,6,Friuli Venezia Giulia,45.6494354,13.76813649,3,0,3,15,18,5,5,0,0,18,376,null,,,2,0,2,3,0,0,5,22
2020-03-05T17:00:00,ITA,6,Friuli Venezia Giulia,45.6494354,13.76813649,4,0,4,17,21,3,3,0,0,21,397,null,,,1,0,1,2,0,0,3,21
2020-03-06T17:00:00,ITA,6,Friuli Venezia Giulia,45.6494354,13.76813649,4,0,4,24,28,7,10,3,0,31,577,null,,,0,0,0,7,3,0,10,180
2020-03-07T18:00:00,ITA,6,Friuli Venezia Giulia,45.6494354,13.76813649,7,1,8,31,39,11,11,3,0,42,577,null,,,3,1,4,7,0,0,11,0
2020-03-08T18:00:00,ITA,6,Friuli Venezia Giulia,45.6494354,13.76813649,7,1,8,45,53,14,15,3,1,57,997,null,,,0,0,0,14,0,1,15,420
2020-03-09T18:00:00,ITA,6,Friuli Venezia Giulia,45.6494354,13.76813649,18,1,19,70,89,36,36,3,1,93,1344,null,,,11,0,11,25,0,0,36,347
2020-03-10T18:00:00,ITA,6,Friuli Venezia Giulia,45.6494354,13.76813649,27,6,33,77,110,21,23,3,3,116,1602,null,,,9,5,14,7,0,2,23,258
2020-03-11T17:00:00,ITA,6,Friuli Venezia Giulia,45.6494354,13.76813649,16,5,21,89,110,0,10,10,6,126,2073,null,,,-11,-1,-12,12,7,3,10,471
2020-03-12T17:00:00,ITA,6,Friuli Venezia Giulia,45.6494354,13.76813649,23,10,33,115,148,38,41,11,8,167,2604,null,,,7,5,12,26,1,2,41,531
2020-03-13T17:00:00,ITA,6,Friuli Venezia Giulia,45.6494354,13.76813649,59,8,67,169,236,88,90,11,10,257,3149,null,,,36,-2,34,54,0,2,90,545
2020-03-14T17:00:00,ITA,6,Friuli Venezia Giulia,45.6494354,13.76813649,67,11,78,193,271,35,44,17,13,301,3376,null,,,8,3,11,24,6,3,44,227
2020-03-15T17:00:00,ITA,6,Friuli Venezia Giulia,45.6494354,13.76813649,98,12,110,206,316,45,46,17,14,347,3407,null,,,31,1,32,13,0,1,46,31
2020-03-16T17:00:00,ITA,6,Friuli Venezia Giulia,45.6494354,13.76813649,96,19,115,231,346,30,39,18,22,386,4851,null,,,-2,7,5,25,1,8,39,1444
2020-03-17T17:00:00,ITA,6,Friuli Venezia Giulia,45.6494354,13.76813649,104,21,125,222,347,1,8,17,30,394,4958,null,,,8,2,10,-9,-1,8,8,107
2020-03-18T17:00:00,ITA,6,Friuli Venezia Giulia,45.6494354,13.76813649,128,27,155,261,416,69,68,15,31,462,4958,null,,,24,6,30,39,-2,1,68,0
2020-03-19T17:00:00,ITA,6,Friuli Venezia Giulia,45.6494354,13.76813649,134,29,163,359,522,106,137,41,36,599,4052,null,,,6,2,8,98,26,5,137,-906
2020-03-20T17:00:00,ITA,6,Friuli Venezia Giulia,45.6494354,13.76813649,143,32,175,380,555,33,57,63,38,656,4964,null,,,9,3,12,21,22,2,57,912
2020-03-21T17:00:00,ITA,6,Friuli Venezia Giulia,45.6494354,13.76813649,152,37,189,477,666,111,134,82,42,790,5955,null,,,9,5,14,97,19,4,134,991
2020-03-22T17:00:00,ITA,6,Friuli Venezia Giulia,45.6494354,13.76813649,163,47,210,528,738,72,84,89,47,874,6761,null,,,11,10,21,51,7,5,84,806
2020-03-23T17:00:00,ITA,6,Friuli Venezia Giulia,45.6494354,13.76813649,185,41,226,545,771,33,56,105,54,930,7424,null,,,22,-6,16,17,16,7,56,663
2020-03-24T17:00:00,ITA,6,Friuli Venezia Giulia,45.6494354,13.76813649,195,49,244,604,848,77,62,80,64,992,8526,null,,,10,8,18,59,-25,10,62,1102
2020-03-25T17:00:00,ITA,6,Friuli Venezia Giulia,45.6494354,13.76813649,200,52,252,659,911,63,147,158,70,1139,9494,null,,,5,3,8,55,78,6,147,968
2020-03-26T17:00:00,ITA,6,Friuli Venezia Giulia,45.6494354,13.76813649,212,54,266,688,954,43,84,197,72,1223,10721,null,,,12,2,14,29,39,2,84,1227
2020-03-27T17:00:00,ITA,6,Friuli Venezia Giulia,45.6494354,13.76813649,222,57,279,748,1027,73,94,214,76,1317,11841,null,,,10,3,13,60,17,4,94,1120
2020-03-28T17:00:00,ITA,6,Friuli Venezia Giulia,45.6494354,13.76813649,223,59,282,838,1120,93,119,229,87,1436,12723,null,,,1,2,3,90,15,11,119,882
2020-03-29T17:00:00,ITA,6,Friuli Venezia Giulia,45.6494354,13.76813649,236,60,296,845,1141,21,44,241,98,1480,13397,null,,,13,1,14,7,12,11,44,674
2020-03-30T17:00:00,ITA,6,Friuli Venezia Giulia,45.6494354,13.76813649,229,60,289,820,1109,-32,21,285,107,1501,14003,null,,,-7,0,-7,-25,44,9,21,606
2020-03-31T17:00:00,ITA,6,Friuli Venezia Giulia,45.6494354,13.76813649,215,60,275,885,1160,51,92,320,113,1593,14899,null,,,-14,0,-14,65,35,6,92,896
2020-04-01T17:00:00,ITA,6,Friuli Venezia Giulia,45.6494354,13.76813649,206,60,266,940,1206,46,92,357,122,1685,15987,null,,,-9,0,-9,55,37,9,92,1088
2020-04-02T17:00:00,ITA,6,Friuli Venezia Giulia,45.6494354,13.76813649,199,60,259,1035,1294,88,114,376,129,1799,17121,null,,,-7,0,-7,95,19,7,114,1134
2020-04-03T17:00:00,ITA,6,Friuli Venezia Giulia,45.6494354,13.76813649,201,61,262,1062,1324,30,80,419,136,1879,19985,null,,,2,1,3,27,43,7,80,2864
2020-04-04T17:00:00,ITA,6,Friuli Venezia Giulia,45.6494354,13.76813649,183,50,233,1103,1336,12,107,505,145,1986,21126,null,,,-18,-11,-29,41,86,9,107,1141
2020-04-05T17:00:00,ITA,6,Friuli Venezia Giulia,45.6494354,13.76813649,185,50,235,1128,1363,27,62,531,154,2048,21652,null,,,2,0,2,25,26,9,62,526
2020-04-06T17:00:00,ITA,6,Friuli Venezia Giulia,45.6494354,13.76813649,189,46,235,1161,1396,33,55,549,158,2103,22272,null,,,4,-4,0,33,18,4,55,620
2020-04-07T17:00:00,ITA,6,Friuli Venezia Giulia,45.6494354,13.76813649,185,44,229,1150,1379,-17,50,610,164,2153,23536,null,,,-4,-2,-6,-11,61,6,50,1264
2020-04-08T17:00:00,ITA,6,Friuli Venezia Giulia,45.6494354,13.76813649,162,41,203,1212,1415,36,65,634,169,2218,24798,null,,,-23,-3,-26,62,24,5,65,1262
2020-04-09T17:00:00,ITA,6,Friuli Venezia Giulia,45.6494354,13.76813649,167,37,204,1186,1390,-25,81,738,171,2299,26205,null,,,5,-4,1,-26,104,2,81,1407
2020-04-10T17:00:00,ITA,6,Friuli Venezia Giulia,45.6494354,13.76813649,167,33,200,1198,1398,8,50,772,179,2349,28097,null,,,0,-4,-4,12,34,8,50,1892
2020-04-11T17:00:00,ITA,6,Friuli Venezia Giulia,45.6494354,13.76813649,172,28,200,1182,1382,-16,44,826,185,2393,29685,null,,,5,-5,0,-16,54,6,44,1588
2020-04-12T17:00:00,ITA,6,Friuli Venezia Giulia,45.6494354,13.76813649,160,28,188,1138,1326,-56,38,910,195,2431,29988,null,,,-12,0,-12,-44,84,10,38,303
2020-04-13T17:00:00,ITA,6,Friuli Venezia Giulia,45.6494354,13.76813649,159,30,189,1118,1307,-19,51,973,202,2482,30941,null,,,-1,2,1,-20,63,7,51,953
2020-04-14T17:00:00,ITA,6,Friuli Venezia Giulia,45.6494354,13.76813649,166,28,194,705,899,-408,38,1415,206,2520,31764,null,,,7,-2,5,-413,442,4,38,823
2020-04-15T17:00:00,ITA,6,Friuli Venezia Giulia,45.6494354,13.76813649,163,24,187,1207,1394,495,24,938,212,2544,33800,null,dc-IT-0004,dc-EN-0004,-3,-4,-7,502,-477,6,24,2036
2020-04-16T17:00:00,ITA,6,Friuli Venezia Giulia,45.6494354,13.76813649,159,26,185,1145,1330,-64,72,1069,217,2616,35766,null,,,-4,2,-2,-62,131,5,72,1966
2020-04-17T17:00:00,ITA,6,Friuli Venezia Giulia,45.6494354,13.76813649,148,23,171,1257,1428,98,59,1027,220,2675,40030,null,,,-11,-3,-14,112,-42,3,59,4264
2020-04-18T17:00:00,ITA,6,Friuli Venezia Giulia,45.6494354,13.76813649,141,27,168,1235,1403,-25,56,1106,222,2731,43293,null,,,-7,4,-3,-22,79,2,56,3263
2020-04-19T17:00:00,ITA,6,Friuli Venezia Giulia,45.6494354,13.76813649,140,25,165,1172,1337,-66,14,1183,225,2745,44622,27544,,,-1,-2,-3,-63,77,3,14,1329
2020-04-20T17:00:00,ITA,6,Friuli Venezia Giulia,45.6494354,13.76813649,140,22,162,1028,1190,-147,30,1346,239,2775,45161,28777,,,0,-3,-3,-144,163,14,30,539
2020-04-21T17:00:00,ITA,6,Friuli Venezia Giulia,45.6494354,13.76813649,139,21,160,1162,1322,132,17,1229,241,2792,48500,31352,,,-1,-1,-2,134,-117,2,17,3339
2020-04-22T17:00:00,ITA,6,Friuli Venezia Giulia,45.6494354,13.76813649,134,20,154,1154,1308,-14,25,1263,246,2817,50869,32871,,,-5,-1,-6,-8,34,5,25,2369
2020-04-23T17:00:00,ITA,6,Friuli Venezia Giulia,45.6494354,13.76813649,138,18,156,979,1135,-173,41,1467,256,2858,52918,34057,,,4,-2,2,-175,204,10,41,2049
2020-04-24T17:00:00,ITA,6,Friuli Venezia Giulia,45.6494354,13.76813649,136,16,152,1168,1320,185,24,1304,258,2882,55502,35547,dc-IT-0008,dc-EN-0008,-2,-2,-4,189,-163,2,24,2584
2020-04-25T17:00:00,ITA,6,Friuli Venezia Giulia,45.6494354,13.76813649,122,15,137,947,1084,-236,21,1556,263,2903,58375,37211,,,-14,-1,-15,-221,252,5,21,2873
2020-04-26T17:00:00,ITA,6,Friuli Venezia Giulia,45.6494354,13.76813649,129,13,142,1106,1248,164,14,1405,264,2917,59681,38202,,,7,-2,5,159,-151,1,14,1306
2020-04-27T17:00:00,ITA,6,Friuli Venezia Giulia,45.6494354,13.76813649,130,13,143,1115,1258,10,60,1448,271,2977,60940,39330,,,1,0,1,9,43,7,60,1259
2020-04-28T17:00:00,ITA,6,Friuli Venezia Giulia,45.6494354,13.76813649,136,13,149,1090,1239,-19,18,1478,278,2995,64151,41273,,,6,0,6,-25,30,7,18,3211
2020-04-29T17:00:00,ITA,6,Friuli Venezia Giulia,45.6494354,13.76813649,134,12,146,1081,1227,-12,15,1498,285,3010,66769,42902,,,-2,-1,-3,-9,20,7,15,2618
2020-04-30T17:00:00,ITA,6,Friuli Venezia Giulia,45.6494354,13.76813649,109,11,120,1050,1170,-57,15,1566,289,3025,67930,43691,,,-25,-1,-26,-31,68,4,15,1161
2020-05-01T17:00:00,ITA,6,Friuli Venezia Giulia,45.6494354,13.76813649,131,6,137,978,1115,-55,16,1632,294,3041,71013,45566,,,22,-5,17,-72,66,5,16,3083
2020-05-02T17:00:00,ITA,6,Friuli Venezia Giulia,45.6494354,13.76813649,131,5,136,973,1109,-6,18,1655,295,3059,73855,47259,,,0,-1,-1,-5,23,1,18,2842
2020-02-24T18:00:00,ITA,7,Liguria,44.41149315,8.9326992,0,0,0,0,0,0,0,0,0,0,1,null,,,0,0,0,0,0,0,0,0
2020-02-25T18:00:00,ITA,7,Liguria,44.41149315,8.9326992,1,0,1,0,1,1,1,0,0,1,39,null,,,1,0,1,0,0,0,1,39
2020-02-26T18:00:00,ITA,7,Liguria,44.41149315,8.9326992,6,0,6,5,11,10,10,0,0,11,66,null,,,5,0,5,5,0,0,10,27
2020-02-27T18:00:00,ITA,7,Liguria,44.41149315,8.9326992,9,0,9,10,19,8,8,0,0,19,78,null,,,3,0,3,5,0,0,8,12
2020-02-28T18:00:00,ITA,7,Liguria,44.41149315,8.9326992,9,0,9,10,19,0,0,0,0,19,112,null,,,0,0,0,0,0,0,0,34
2020-02-29T17:00:00,ITA,7,Liguria,44.41149315,8.9326992,4,1,5,33,38,19,23,4,0,42,121,null,,,-5,1,-4,23,4,0,23,9
2020-03-01T17:00:00,ITA,7,Liguria,44.41149315,8.9326992,12,1,13,8,21,-17,-17,4,0,25,121,null,,,8,0,8,-25,0,0,-17,0
2020-03-02T18:00:00,ITA,7,Liguria,44.41149315,8.9326992,12,1,13,5,18,-3,-3,4,0,22,121,null,,,0,0,0,-3,0,0,-3,0
2020-03-03T18:00:00,ITA,7,Liguria,44.41149315,8.9326992,12,2,14,5,19,1,2,4,1,24,121,null,,,0,1,1,0,0,1,2,0
2020-03-04T17:00:00,ITA,7,Liguria,44.41149315,8.9326992,10,3,13,8,21,2,2,4,1,26,133,null,,,-2,1,-1,3,0,0,2,12
2020-03-05T17:00:00,ITA,7,Liguria,44.41149315,8.9326992,11,3,14,7,21,0,2,4,3,28,146,null,,,1,0,1,-1,0,2,2,13
2020-03-06T17:00:00,ITA,7,Liguria,44.41149315,8.9326992,12,5,17,7,24,3,4,5,3,32,229,null,,,1,2,3,0,1,0,4,83
2020-03-07T18:00:00,ITA,7,Liguria,44.41149315,8.9326992,26,6,32,10,42,18,19,5,4,51,331,null,,,14,1,15,3,0,1,19,102
2020-03-08T18:00:00,ITA,7,Liguria,44.41149315,8.9326992,39,11,50,17,67,25,27,5,6,78,401,null,,,13,5,18,7,0,2,27,70
2020-03-09T18:00:00,ITA,7,Liguria,44.41149315,8.9326992,60,17,77,20,97,30,31,5,7,109,611,null,,,21,6,27,3,0,1,31,210
2020-03-10T18:00:00,ITA,7,Liguria,44.41149315,8.9326992,57,29,86,42,128,31,32,5,8,141,694,null,,,-3,12,9,22,0,1,32,83
2020-03-11T17:00:00,ITA,7,Liguria,44.41149315,8.9326992,74,34,108,73,181,53,53,5,8,194,1025,null,,,17,5,22,31,0,0,53,331
2020-03-12T17:00:00,ITA,7,Liguria,44.41149315,8.9326992,100,36,136,107,243,62,80,20,11,274,1174,null,,,26,2,28,34,15,3,80,149
2020-03-13T17:00:00,ITA,7,Liguria,44.41149315,8.9326992,128,44,172,132,304,61,71,24,17,345,1442,null,,,28,8,36,25,4,6,71,268
2020-03-14T17:00:00,ITA,7,Liguria,44.41149315,8.9326992,213,62,275,109,384,80,118,52,27,463,1750,null,,,85,18,103,-23,28,10,118,308
2020-03-15T17:00:00,ITA,7,Liguria,44.41149315,8.9326992,253,66,319,174,493,109,96,33,33,559,1973,null,,,40,4,44,65,-19,6,96,223
2020-03-16T17:00:00,ITA,7,Liguria,44.41149315,8.9326992,255,73,328,247,575,82,108,42,50,667,2189,null,,,2,7,9,73,9,17,108,216
2020-03-17T17:00:00,ITA,7,Liguria,44.41149315,8.9326992,299,85,384,277,661,86,111,57,60,778,2509,null,,,44,12,56,30,15,10,111,320
2020-03-18T17:00:00,ITA,7,Liguria,44.41149315,8.9326992,401,100,501,243,744,83,109,70,73,887,2912,null,,,102,15,117,-34,13,13,109,403
2020-03-19T17:00:00,ITA,7,Liguria,44.41149315,8.9326992,491,112,603,280,883,139,172,85,91,1059,3348,null,,,90,12,102,37,15,18,172,436
2020-03-20T17:00:00,ITA,7,Liguria,44.41149315,8.9326992,573,121,694,307,1001,118,162,101,119,1221,3794,null,,,82,9,91,27,16,28,162,446
2020-03-21T17:00:00,ITA,7,Liguria,44.41149315,8.9326992,598,129,727,432,1159,158,215,125,152,1436,4304,null,,,25,8,33,125,24,33,215,510
2020-03-22T17:00:00,ITA,7,Liguria,44.41149315,8.9326992,736,132,868,483,1351,192,229,143,171,1665,4995,null,,,138,3,141,51,18,19,229,691
2020-03-23T17:00:00,ITA,7,Liguria,44.41149315,8.9326992,761,133,894,659,1553,202,259,159,212,1924,5538,null,,,25,1,26,176,16,41,259,543
2020-03-24T17:00:00,ITA,7,Liguria,44.41149315,8.9326992,803,147,950,742,1692,139,192,193,231,2116,5992,null,,,42,14,56,83,34,19,192,454
2020-03-25T17:00:00,ITA,7,Liguria,44.41149315,8.9326992,927,147,1074,752,1826,134,189,225,254,2305,6602,null,,,124,0,124,10,32,23,189,610
2020-03-26T17:00:00,ITA,7,Liguria,44.41149315,8.9326992,998,154,1152,875,2027,201,262,260,280,2567,7304,null,,,71,7,78,123,35,26,262,702
2020-03-27T17:00:00,ITA,7,Liguria,44.41149315,8.9326992,1023,157,1180,880,2060,33,129,305,331,2696,7804,null,,,25,3,28,5,45,51,129,500
2020-03-28T17:00:00,ITA,7,Liguria,44.41149315,8.9326992,1031,167,1198,888,2086,26,126,378,358,2822,8177,null,,,8,10,18,8,73,27,126,373
2020-03-29T17:00:00,ITA,7,Liguria,44.41149315,8.9326992,1077,166,1243,1036,2279,193,254,420,377,3076,9100,null,,,46,-1,45,148,42,19,254,923
2020-03-30T17:00:00,ITA,7,Liguria,44.41149315,8.9326992,1142,175,1317,1066,2383,104,141,437,397,3217,9677,null,,,65,9,74,30,17,20,141,577
2020-03-31T17:00:00,ITA,7,Liguria,44.41149315,8.9326992,1153,179,1332,1176,2508,125,199,480,428,3416,10376,null,,,11,4,15,110,43,31,199,699
2020-04-01T17:00:00,ITA,7,Liguria,44.41149315,8.9326992,1114,179,1293,1352,2645,137,244,555,460,3660,11334,null,,,-39,0,-39,176,75,32,244,958
2020-04-02T17:00:00,ITA,7,Liguria,44.41149315,8.9326992,1120,172,1292,1368,2660,15,122,634,488,3782,12069,null,,,6,-7,-1,16,79,28,122,735
2020-04-03T17:00:00,ITA,7,Liguria,44.41149315,8.9326992,1147,173,1320,1426,2746,86,183,700,519,3965,12934,null,,,27,1,28,58,66,31,183,865
2020-04-04T17:00:00,ITA,7,Liguria,44.41149315,8.9326992,1121,169,1290,1604,2894,148,238,767,542,4203,14087,null,,,-26,-4,-30,178,67,23,238,1153
2020-04-05T17:00:00,ITA,7,Liguria,44.41149315,8.9326992,1126,165,1291,1802,3093,199,246,800,556,4449,15047,null,,,5,-4,1,198,33,14,246,960
2020-04-06T17:00:00,ITA,7,Liguria,44.41149315,8.9326992,1141,162,1303,1814,3117,24,100,837,595,4549,15533,null,,,15,-3,12,12,37,39,100,486
2020-04-07T17:00:00,ITA,7,Liguria,44.41149315,8.9326992,1090,156,1246,1966,3212,95,208,925,620,4757,16579,null,,,-51,-6,-57,152,88,25,208,1046
2020-04-08T17:00:00,ITA,7,Liguria,44.41149315,8.9326992,1109,153,1262,1983,3245,33,149,1007,654,4906,17521,null,,,19,-3,16,17,82,34,149,942
2020-04-09T17:00:00,ITA,7,Liguria,44.41149315,8.9326992,1103,154,1257,1996,3253,8,114,1085,682,5020,18446,null,,,-6,1,-5,13,78,28,114,925
2020-04-10T17:00:00,ITA,7,Liguria,44.41149315,8.9326992,1076,151,1227,2074,3301,48,171,1181,709,5191,19514,null,,,-27,-3,-30,78,96,27,171,1068
2020-04-11T17:00:00,ITA,7,Liguria,44.41149315,8.9326992,1003,146,1149,2184,3333,32,185,1309,734,5376,20888,null,,,-73,-5,-78,110,128,25,185,1374
2020-04-12T17:00:00,ITA,7,Liguria,44.41149315,8.9326992,1032,144,1176,2157,3333,0,118,1412,749,5494,21983,null,,,29,-2,27,-27,103,15,118,1095
2020-04-13T17:00:00,ITA,7,Liguria,44.41149315,8.9326992,1088,138,1226,2139,3365,32,102,1471,760,5596,23129,null,,,56,-6,50,-18,59,11,102,1146
2020-04-14T17:00:00,ITA,7,Liguria,44.41149315,8.9326992,967,133,1100,2366,3466,101,212,1549,793,5808,24446,null,,,-121,-5,-126,227,78,33,212,1317
2020-04-15T17:00:00,ITA,7,Liguria,44.41149315,8.9326992,959,120,1079,2385,3464,-2,128,1665,807,5936,25793,null,,,-8,-13,-21,19,116,14,128,1347
2020-04-16T17:00:00,ITA,7,Liguria,44.41149315,8.9326992,957,103,1060,2377,3437,-27,103,1774,828,6039,26945,null,,,-2,-17,-19,-8,109,21,103,1152
2020-04-17T17:00:00,ITA,7,Liguria,44.41149315,8.9326992,897,105,1002,2457,3459,22,149,1863,866,6188,28181,null,,,-60,2,-58,80,89,38,149,1236
2020-04-18T17:00:00,ITA,7,Liguria,44.41149315,8.9326992,901,105,1006,2406,3412,-47,113,1992,897,6301,29322,null,,,4,0,4,-51,129,31,113,1141
2020-04-19T17:00:00,ITA,7,Liguria,44.41149315,8.9326992,885,101,986,2504,3490,78,227,2110,928,6528,31551,21103,,,-16,-4,-20,98,118,31,227,2229
2020-04-20T17:00:00,ITA,7,Liguria,44.41149315,8.9326992,878,102,980,2516,3496,6,141,2216,957,6669,33007,21979,,,-7,1,-6,12,106,29,141,1456
2020-04-21T17:00:00,ITA,7,Liguria,44.41149315,8.9326992,914,94,1008,2455,3463,-33,95,2311,990,6764,34186,22670,,,36,-8,28,-61,95,33,95,1179
2020-04-22T17:00:00,ITA,7,Liguria,44.41149315,8.9326992,860,92,952,2524,3476,13,154,2420,1022,6918,35990,23756,,,-54,-2,-56,69,109,32,154,1804
2020-04-23T17:00:00,ITA,7,Liguria,44.41149315,8.9326992,783,91,874,2592,3466,-10,131,2536,1047,7049,37842,25045,,,-77,-1,-78,68,116,25,131,1852
2020-04-24T17:00:00,ITA,7,Liguria,44.41149315,8.9326992,760,87,847,2590,3437,-29,124,2660,1076,7173,39563,26040,,,-23,-4,-27,-2,124,29,124,1721
2020-04-25T17:00:00,ITA,7,Liguria,44.41149315,8.9326992,759,83,842,2591,3433,-4,128,2775,1093,7301,41125,26898,,,-1,-4,-5,1,115,17,128,1562
2020-04-26T17:00:00,ITA,7,Liguria,44.41149315,8.9326992,748,82,830,2650,3480,47,187,2894,1114,7488,42607,27852,,,-11,-1,-12,59,119,21,187,1482
2020-04-27T17:00:00,ITA,7,Liguria,44.41149315,8.9326992,754,83,837,2743,3580,100,154,2934,1128,7642,44039,28739,,,6,1,7,93,40,14,154,1432
2020-04-28T17:00:00,ITA,7,Liguria,44.41149315,8.9326992,718,81,799,2772,3571,-9,130,3060,1141,7772,45719,29794,,,-36,-2,-38,29,126,13,130,1680
2020-04-29T17:00:00,ITA,7,Liguria,44.41149315,8.9326992,697,70,767,2809,3576,5,117,3161,1152,7889,47220,30669,,,-21,-11,-32,37,101,11,117,1501
2020-04-30T17:00:00,ITA,7,Liguria,44.41149315,8.9326992,676,69,745,2806,3551,-25,104,3275,1167,7993,48762,31520,,,-21,-1,-22,-3,114,15,104,1542
2020-05-01T17:00:00,ITA,7,Liguria,44.41149315,8.9326992,666,68,734,2784,3518,-33,133,3424,1184,8126,51199,32794,,,-10,-1,-11,-22,149,17,133,2437
2020-05-02T17:00:00,ITA,7,Liguria,44.41149315,8.9326992,647,68,715,2883,3598,80,186,3519,1195,8312,53202,34037,,,-19,0,-19,99,95,11,186,2003
2020-02-24T18:00:00,ITA,8,Emilia-Romagna,44.49436681,11.3417208,10,2,12,6,18,0,18,0,0,18,148,null,,,0,0,0,0,0,0,0,0
2020-02-25T18:00:00,ITA,8,Emilia-Romagna,44.49436681,11.3417208,15,2,17,9,26,8,8,0,0,26,391,null,,,15,2,17,9,0,0,26,391
2020-02-26T18:00:00,ITA,8,Emilia-Romagna,44.49436681,11.3417208,20,3,23,23,46,20,21,0,1,47,577,null,,,5,1,6,14,0,1,21,186
2020-02-27T18:00:00,ITA,8,Emilia-Romagna,44.49436681,11.3417208,36,6,42,54,96,50,50,0,1,97,1033,null,,,16,3,19,31,0,0,50,456
2020-02-28T18:00:00,ITA,8,Emilia-Romagna,44.49436681,11.3417208,56,6,62,81,143,47,48,0,2,145,1277,null,,,20,0,20,27,0,1,48,244
2020-02-29T17:00:00,ITA,8,Emilia-Romagna,44.49436681,11.3417208,86,11,97,116,213,70,72,0,4,217,1550,null,,,30,5,35,35,0,2,72,273
2020-03-01T17:00:00,ITA,8,Emilia-Romagna,44.49436681,11.3417208,127,13,140,137,277,64,68,0,8,285,1795,null,,,41,2,43,21,0,4,68,245
2020-03-02T18:00:00,ITA,8,Emilia-Romagna,44.49436681,11.3417208,148,16,164,160,324,47,50,0,11,335,1973,null,,,21,3,24,23,0,3,50,178
2020-03-03T18:00:00,ITA,8,Emilia-Romagna,44.49436681,11.3417208,187,24,211,187,398,74,85,4,18,420,2012,null,,,39,8,47,27,4,7,85,39
2020-03-04T17:00:00,ITA,8,Emilia-Romagna,44.49436681,11.3417208,256,26,282,234,516,118,124,6,22,544,2500,null,,,69,2,71,47,2,4,124,488
2020-03-05T17:00:00,ITA,8,Emilia-Romagna,44.49436681,11.3417208,327,32,359,299,658,142,154,10,30,698,2884,null,,,71,6,77,65,4,8,154,384
2020-03-06T17:00:00,ITA,8,Emilia-Romagna,44.49436681,11.3417208,397,53,450,366,816,158,172,17,37,870,3136,null,,,70,21,91,67,7,7,172,252
2020-03-07T18:00:00,ITA,8,Emilia-Romagna,44.49436681,11.3417208,464,64,528,409,937,121,140,25,48,1010,3604,null,,,67,11,78,43,8,11,140,468
2020-03-08T18:00:00,ITA,8,Emilia-Romagna,44.49436681,11.3417208,542,75,617,480,1097,160,170,27,56,1180,4344,null,,,78,11,89,71,2,8,170,740
2020-03-09T18:00:00,ITA,8,Emilia-Romagna,44.49436681,11.3417208,576,90,666,620,1286,189,206,30,70,1386,4906,null,,,34,15,49,140,3,14,206,562
2020-03-10T18:00:00,ITA,8,Emilia-Romagna,44.49436681,11.3417208,669,98,767,650,1417,131,147,31,85,1533,5494,null,,,93,8,101,30,1,15,147,588
2020-03-11T17:00:00,ITA,8,Emilia-Romagna,44.49436681,11.3417208,745,104,849,739,1588,171,206,38,113,1739,6640,null,,,76,6,82,89,7,28,206,1146
2020-03-12T17:00:00,ITA,8,Emilia-Romagna,44.49436681,11.3417208,814,112,926,832,1758,170,208,43,146,1947,7600,null,,,69,8,77,93,5,33,208,960
2020-03-13T17:00:00,ITA,8,Emilia-Romagna,44.49436681,11.3417208,942,128,1070,941,2011,253,316,51,201,2263,8787,null,,,128,16,144,109,8,55,316,1187
2020-03-14T17:00:00,ITA,8,Emilia-Romagna,44.49436681,11.3417208,1076,152,1228,1121,2349,338,381,54,241,2644,10043,null,,,134,24,158,180,3,40,381,1256
2020-03-15T17:00:00,ITA,8,Emilia-Romagna,44.49436681,11.3417208,1215,169,1384,1357,2741,392,449,68,284,3093,12054,null,,,139,17,156,236,14,43,449,2011
2020-03-16T17:00:00,ITA,8,Emilia-Romagna,44.49436681,11.3417208,1362,197,1559,1529,3088,347,429,88,346,3522,13096,null,,,147,28,175,172,20,62,429,1042
2020-03-17T17:00:00,ITA,8,Emilia-Romagna,44.49436681,11.3417208,1566,223,1789,1615,3404,316,409,134,393,3931,14510,null,nd-IT-0008,nd-EN-0008,204,26,230,86,46,47,409,1414
2020-03-18T17:00:00,ITA,8,Emilia-Romagna,44.49436681,11.3417208,1784,247,2031,1884,3915,511,594,152,458,4525,15461,null,nd-IT-0011,nd-EN-0011,218,24,242,269,18,65,594,951
2020-03-19T17:00:00,ITA,8,Emilia-Romagna,44.49436681,11.3417208,1900,260,2160,2346,4506,591,689,177,531,5214,18344,null,,,116,13,129,462,25,73,689,2883
2020-03-20T17:00:00,ITA,8,Emilia-Romagna,44.49436681,11.3417208,2083,267,2350,2739,5089,583,754,239,640,5968,20753,null,,,183,7,190,393,62,109,754,2409
2020-03-21T17:00:00,ITA,8,Emilia-Romagna,44.49436681,11.3417208,2267,265,2532,3129,5661,572,737,329,715,6705,24620,null,,,184,-2,182,390,90,75,737,3867
2020-03-22T17:00:00,ITA,8,Emilia-Romagna,44.49436681,11.3417208,2429,269,2698,3692,6390,729,850,349,816,7555,28022,null,,,162,4,166,563,20,101,850,3402
2020-03-23T17:00:00,ITA,8,Emilia-Romagna,44.49436681,11.3417208,2846,276,3122,4098,7220,830,980,423,892,8535,31200,null,,,417,7,424,406,74,76,980,3178
2020-03-24T17:00:00,ITA,8,Emilia-Romagna,44.49436681,11.3417208,2974,291,3265,4446,7711,491,719,558,985,9254,33527,null,,,128,15,143,348,135,93,719,2327
2020-03-25T17:00:00,ITA,8,Emilia-Romagna,44.49436681,11.3417208,3180,294,3474,4782,8256,545,800,721,1077,10054,38045,null,,,206,3,209,336,163,92,800,4518
2020-03-26T17:00:00,ITA,8,Emilia-Romagna,44.49436681,11.3417208,3354,301,3655,5195,8850,594,762,792,1174,10816,42395,null,,,174,7,181,413,71,97,762,4350
2020-03-27T17:00:00,ITA,8,Emilia-Romagna,44.49436681,11.3417208,3461,308,3769,5592,9361,511,772,960,1267,11588,47798,null,,,107,7,114,397,168,93,772,5403
2020-03-28T17:00:00,ITA,8,Emilia-Romagna,44.49436681,11.3417208,3695,316,4011,5953,9964,603,795,1075,1344,12383,52991,null,,,234,8,242,361,115,77,795,5193
2020-03-29T17:00:00,ITA,8,Emilia-Romagna,44.49436681,11.3417208,3769,333,4102,6433,10535,571,736,1141,1443,13119,52991,null,pd-IT-0008,pd-EN-0008,74,17,91,480,66,99,736,0
2020-03-30T17:00:00,ITA,8,Emilia-Romagna,44.49436681,11.3417208,3779,351,4130,6636,10766,231,412,1227,1538,13531,50990,null,,,10,18,28,203,86,95,412,-2001
2020-03-31T17:00:00,ITA,8,Emilia-Romagna,44.49436681,11.3417208,3765,353,4118,6835,10953,187,543,1477,1644,14074,54532,null,,,-14,2,-12,199,250,106,543,3542
2020-04-01T17:00:00,ITA,8,Emilia-Romagna,44.49436681,11.3417208,3898,359,4257,7232,11489,536,713,1566,1732,14787,58457,null,,,133,6,139,397,89,88,713,3925
2020-04-02T17:00:00,ITA,8,Emilia-Romagna,44.49436681,11.3417208,3944,366,4310,7549,11859,370,546,1663,1811,15333,60507,null,,,46,7,53,317,97,79,546,2050
2020-04-03T17:00:00,ITA,8,Emilia-Romagna,44.49436681,11.3417208,3915,364,4279,7899,12178,319,599,1852,1902,15932,63682,null,,,-29,-2,-31,350,189,91,599,3175
2020-04-04T17:00:00,ITA,8,Emilia-Romagna,44.49436681,11.3417208,3859,358,4217,8306,12523,345,608,2040,1977,16540,67075,null,,,-56,-6,-62,407,188,75,608,3393
2020-04-05T17:00:00,ITA,8,Emilia-Romagna,44.49436681,11.3417208,3839,375,4214,8623,12837,314,549,2201,2051,17089,69986,null,,,-20,17,-3,317,161,74,549,2911
2020-04-06T17:00:00,ITA,8,Emilia-Romagna,44.49436681,11.3417208,3804,372,4176,8875,13051,214,467,2397,2108,17556,72163,null,,,-35,-3,-38,252,196,57,467,2177
2020-04-07T17:00:00,ITA,8,Emilia-Romagna,44.49436681,11.3417208,3750,366,4116,8932,13048,-3,269,2597,2180,17825,75191,null,,,-54,-6,-60,57,200,72,269,3028
2020-04-08T17:00:00,ITA,8,Emilia-Romagna,44.49436681,11.3417208,3769,361,4130,8980,13110,62,409,2890,2234,18234,78367,null,,,19,-5,14,48,293,54,409,3176
2020-04-09T17:00:00,ITA,8,Emilia-Romagna,44.49436681,11.3417208,3722,355,4077,9181,13258,148,443,3103,2316,18677,81715,null,,,-47,-6,-53,201,213,82,443,3348
2020-04-10T17:00:00,ITA,8,Emilia-Romagna,44.49436681,11.3417208,3596,349,3945,9405,13350,92,451,3381,2397,19128,85884,null,,,-126,-6,-132,224,278,81,451,4169
2020-04-11T17:00:00,ITA,8,Emilia-Romagna,44.49436681,11.3417208,3530,341,3871,9624,13495,145,507,3659,2481,19635,91759,null,,,-66,-8,-74,219,278,84,507,5875
2020-04-12T17:00:00,ITA,8,Emilia-Romagna,44.49436681,11.3417208,3491,335,3826,9846,13672,177,463,3862,2564,20098,96704,null,,,-39,-6,-45,222,203,83,463,4945
2020-04-13T17:00:00,ITA,8,Emilia-Romagna,44.49436681,11.3417208,3490,331,3821,9997,13818,146,342,4007,2615,20440,99047,null,,,-1,-4,-5,151,145,51,342,2343
2020-04-14T17:00:00,ITA,8,Emilia-Romagna,44.49436681,11.3417208,3473,328,3801,9977,13778,-40,312,4269,2705,20752,101896,null,,,-17,-3,-20,-20,262,90,312,2849
2020-04-15T17:00:00,ITA,8,Emilia-Romagna,44.49436681,11.3417208,3388,325,3713,9864,13577,-201,277,4664,2788,21029,106149,null,,,-85,-3,-88,-113,395,83,277,4253
2020-04-16T17:00:00,ITA,8,Emilia-Romagna,44.49436681,11.3417208,3360,316,3676,9987,13663,86,457,4980,2843,21486,112105,null,,,-28,-9,-37,123,316,55,457,5956
2020-04-17T17:00:00,ITA,8,Emilia-Romagna,44.49436681,11.3417208,3330,309,3639,9946,13585,-78,348,5346,2903,21834,116826,null,,,-30,-7,-37,-41,366,60,348,4721
2020-04-18T17:00:00,ITA,8,Emilia-Romagna,44.49436681,11.3417208,3234,296,3530,10054,13584,-1,350,5635,2965,22184,121220,null,,,-96,-13,-109,108,289,62,350,4394
2020-04-19T17:00:00,ITA,8,Emilia-Romagna,44.49436681,11.3417208,3166,289,3455,10097,13552,-32,376,5985,3023,22560,124916,88776,,,-68,-7,-75,43,350,58,376,3696
2020-04-20T17:00:00,ITA,8,Emilia-Romagna,44.49436681,11.3417208,3144,283,3427,10095,13522,-30,307,6266,3079,22867,129530,90894,,,-22,-6,-28,-2,281,56,307,4614
2020-04-21T17:00:00,ITA,8,Emilia-Romagna,44.49436681,11.3417208,3045,282,3327,9917,13244,-278,225,6701,3147,23092,134878,93367,,,-99,-1,-100,-178,435,68,225,5348
2020-04-22T17:00:00,ITA,8,Emilia-Romagna,44.49436681,11.3417208,2964,282,3246,9838,13084,-160,342,7146,3204,23434,140874,96824,,,-81,0,-81,-79,445,57,342,5996
2020-04-23T17:00:00,ITA,8,Emilia-Romagna,44.49436681,11.3417208,2889,266,3155,9690,12845,-239,289,7609,3269,23723,146146,99714,,,-75,-16,-91,-148,463,65,289,5272
2020-04-24T17:00:00,ITA,8,Emilia-Romagna,44.49436681,11.3417208,2807,264,3071,9438,12509,-336,247,8158,3303,23970,151505,102495,,,-82,-2,-84,-252,549,34,247,5359
2020-04-25T17:00:00,ITA,8,Emilia-Romagna,44.49436681,11.3417208,2718,246,2964,9383,12347,-162,239,8515,3347,24209,156883,105628,,,-89,-18,-107,-55,357,44,239,5378
2020-04-26T17:00:00,ITA,8,Emilia-Romagna,44.49436681,11.3417208,2695,245,2940,9401,12341,-6,241,8723,3386,24450,161928,109192,,,-23,-1,-24,18,208,39,241,5045
2020-04-27T17:00:00,ITA,8,Emilia-Romagna,44.49436681,11.3417208,2640,247,2887,9338,12225,-116,212,9006,3431,24662,164979,111041,,,-55,2,-53,-63,283,45,212,3051
2020-04-28T17:00:00,ITA,8,Emilia-Romagna,44.49436681,11.3417208,2574,228,2802,9201,12003,-222,252,9439,3472,24914,172589,116624,,,-66,-19,-85,-137,433,41,252,7610
2020-04-29T17:00:00,ITA,8,Emilia-Romagna,44.49436681,11.3417208,2527,226,2753,9109,11862,-141,263,9803,3512,25177,176865,118881,,,-47,-2,-49,-92,364,40,263,4276
2020-04-30T17:00:00,ITA,8,Emilia-Romagna,44.49436681,11.3417208,2146,206,2352,7211,9563,-2299,259,12322,3551,25436,182857,122430,,,-381,-20,-401,-1898,2519,39,259,5992
2020-05-01T17:00:00,ITA,8,Emilia-Romagna,44.49436681,11.3417208,2112,197,2309,7175,9484,-79,208,12581,3579,25644,188264,125636,,,-34,-9,-43,-36,259,28,208,5407
2020-05-02T17:00:00,ITA,8,Emilia-Romagna,44.49436681,11.3417208,2033,196,2229,7094,9323,-161,206,12913,3614,25850,192135,128005,,,-79,-1,-80,-81,332,35,206,3871
2020-02-24T18:00:00,ITA,9,Toscana,43.76923077,11.25588885,0,0,0,0,0,0,0,0,0,0,140,null,,,0,0,0,0,0,0,0,0
2020-02-25T18:00:00,ITA,9,Toscana,43.76923077,11.25588885,2,0,2,0,2,2,2,0,0,2,296,null,,,2,0,2,0,0,0,2,296
2020-02-26T18:00:00,ITA,9,Toscana,43.76923077,11.25588885,2,0,2,0,2,0,0,0,0,2,363,null,,,0,0,0,0,0,0,0,67
2020-02-27T18:00:00,ITA,9,Toscana,43.76923077,11.25588885,2,0,2,0,2,0,0,0,0,2,410,null,,,0,0,0,0,0,0,0,47
2020-02-28T18:00:00,ITA,9,Toscana,43.76923077,11.25588885,5,0,5,2,7,5,6,1,0,8,437,null,,,3,0,3,2,1,0,6,27
2020-02-29T17:00:00,ITA,9,Toscana,43.76923077,11.25588885,7,0,7,3,10,3,3,1,0,11,531,null,,,2,0,2,1,0,0,3,94
2020-03-01T17:00:00,ITA,9,Toscana,43.76923077,11.25588885,7,0,7,5,12,2,2,1,0,13,572,null,,,0,0,0,2,0,0,2,41
2020-03-02T18:00:00,ITA,9,Toscana,43.76923077,11.25588885,7,0,7,5,12,0,0,1,0,13,613,null,,,0,0,0,0,0,0,0,41
2020-03-03T18:00:00,ITA,9,Toscana,43.76923077,11.25588885,10,0,10,8,18,6,6,1,0,19,697,null,,,3,0,3,3,0,0,6,84
2020-03-04T17:00:00,ITA,9,Toscana,43.76923077,11.25588885,15,2,17,20,37,19,19,1,0,38,776,null,,,5,2,7,12,0,0,19,79
2020-03-05T17:00:00,ITA,9,Toscana,43.76923077,11.25588885,26,3,29,31,60,23,23,1,0,61,776,null,,,11,1,12,11,0,0,23,0
2020-03-06T17:00:00,ITA,9,Toscana,43.76923077,11.25588885,35,5,40,38,78,18,18,1,0,79,1097,null,,,9,2,11,7,0,0,18,321
2020-03-07T18:00:00,ITA,9,Toscana,43.76923077,11.25588885,54,7,61,51,112,34,34,1,0,113,1331,null,,,19,2,21,13,0,0,34,234
2020-03-08T18:00:00,ITA,9,Toscana,43.76923077,11.25588885,91,7,98,67,165,53,53,1,0,166,1618,null,,,37,0,37,16,0,0,53,287
2020-03-09T18:00:00,ITA,9,Toscana,43.76923077,11.25588885,107,9,116,90,206,41,42,1,1,208,2018,null,,,16,2,18,23,0,1,42,400
2020-03-10T18:00:00,ITA,9,Toscana,43.76923077,11.25588885,91,40,131,129,260,54,56,3,1,264,2573,null,,,-16,31,15,39,2,0,56,555
2020-03-11T17:00:00,ITA,9,Toscana,43.76923077,11.25588885,87,54,141,173,314,54,56,5,1,320,2804,null,,,-4,14,10,44,2,0,56,231
2020-03-12T17:00:00,ITA,9,Toscana,43.76923077,11.25588885,100,59,159,193,352,38,44,7,5,364,3165,null,,,13,5,18,20,2,4,44,361
2020-03-13T17:00:00,ITA,9,Toscana,43.76923077,11.25588885,134,77,211,244,455,103,106,10,5,470,4049,null,,,34,18,52,51,3,0,106,884
2020-03-14T17:00:00,ITA,9,Toscana,43.76923077,11.25588885,160,87,247,367,614,159,160,10,6,630,4595,null,,,26,10,36,123,0,1,160,546
2020-03-15T17:00:00,ITA,9,Toscana,43.76923077,11.25588885,175,107,282,481,763,149,151,10,8,781,5132,null,,,15,20,35,114,0,2,151,537
2020-03-16T17:00:00,ITA,9,Toscana,43.76923077,11.25588885,175,107,282,559,841,78,85,11,14,866,5910,null,,,0,0,0,78,1,6,85,778
2020-03-17T17:00:00,ITA,9,Toscana,43.76923077,11.25588885,329,143,472,552,1024,183,187,12,17,1053,6727,null,,,154,36,190,-7,1,3,187,817
2020-03-18T17:00:00,ITA,9,Toscana,43.76923077,11.25588885,427,160,587,704,1291,267,277,17,22,1330,7606,null,,,98,17,115,152,5,5,277,879
2020-03-19T17:00:00,ITA,9,Toscana,43.76923077,11.25588885,501,178,679,743,1422,131,152,22,38,1482,8873,null,,,74,18,92,39,5,16,152,1267
2020-03-20T17:00:00,ITA,9,Toscana,43.76923077,11.25588885,601,189,790,923,1713,291,311,33,47,1793,10405,null,,,100,11,111,180,11,9,311,1532
2020-03-21T17:00:00,ITA,9,Toscana,43.76923077,11.25588885,664,202,866,1039,1905,192,219,35,72,2012,11909,null,,,63,13,76,116,2,25,219,1504
2020-03-22T17:00:00,ITA,9,Toscana,43.76923077,11.25588885,706,215,921,1223,2144,239,265,42,91,2277,13264,null,,,42,13,55,184,7,19,265,1355
2020-03-23T17:00:00,ITA,9,Toscana,43.76923077,11.25588885,838,238,1076,1225,2301,157,184,51,109,2461,13851,null,,,132,23,155,2,9,18,184,587
2020-03-24T17:00:00,ITA,9,Toscana,43.76923077,11.25588885,918,244,1162,1357,2519,218,238,51,129,2699,15701,null,,,80,6,86,132,0,20,238,1850
2020-03-25T17:00:00,ITA,9,Toscana,43.76923077,11.25588885,999,251,1250,1526,2776,257,273,54,142,2972,17868,null,,,81,7,88,169,3,13,273,2167
2020-03-26T17:00:00,ITA,9,Toscana,43.76923077,11.25588885,1037,259,1296,1677,2973,197,254,95,158,3226,20952,null,,,38,8,46,151,41,16,254,3084
2020-03-27T17:00:00,ITA,9,Toscana,43.76923077,11.25588885,1053,274,1327,1843,3170,197,224,103,177,3450,23746,null,,,16,15,31,166,8,19,224,2794
2020-03-28T17:00:00,ITA,9,Toscana,43.76923077,11.25588885,1093,277,1370,2141,3511,341,367,108,198,3817,25613,null,,,40,3,43,298,5,21,367,1867
2020-03-29T17:00:00,ITA,9,Toscana,43.76923077,11.25588885,1111,275,1386,2400,3786,275,305,121,215,4122,27579,null,,,18,-2,16,259,13,17,305,1966
2020-03-30T17:00:00,ITA,9,Toscana,43.76923077,11.25588885,1116,279,1395,2655,4050,264,290,131,231,4412,30099,null,,,5,4,9,255,10,16,290,2520
2020-03-31T17:00:00,ITA,9,Toscana,43.76923077,11.25588885,1120,293,1413,2813,4226,176,196,138,244,4608,33165,null,,,4,14,18,158,7,13,196,3066
2020-04-01T17:00:00,ITA,9,Toscana,43.76923077,11.25588885,1120,297,1417,3015,4432,206,259,182,253,4867,36575,null,,,0,4,4,202,44,9,259,3410
2020-04-02T17:00:00,ITA,9,Toscana,43.76923077,11.25588885,1135,295,1430,3359,4789,357,406,216,268,5273,40724,null,,,15,-2,13,344,34,15,406,4149
2020-04-03T17:00:00,ITA,9,Toscana,43.76923077,11.25588885,1149,288,1437,3472,4909,120,226,300,290,5499,44460,null,,,14,-7,7,113,84,22,226,3736
2020-04-04T17:00:00,ITA,9,Toscana,43.76923077,11.25588885,1129,286,1415,3639,5054,145,172,310,307,5671,47886,null,,,-20,-2,-22,167,10,17,172,3426
2020-04-05T17:00:00,ITA,9,Toscana,43.76923077,11.25588885,1111,276,1387,3798,5185,131,176,337,325,5847,51006,null,,,-18,-10,-28,159,27,18,176,3120
2020-04-06T17:00:00,ITA,9,Toscana,43.76923077,11.25588885,1116,279,1395,3906,5301,116,154,350,350,6001,52849,null,,,5,3,8,108,13,25,154,1843
2020-04-07T17:00:00,ITA,9,Toscana,43.76923077,11.25588885,1087,263,1350,4077,5427,126,172,377,369,6173,56651,null,,,-29,-16,-45,171,27,19,172,3802
2020-04-08T17:00:00,ITA,9,Toscana,43.76923077,11.25588885,1066,260,1326,4231,5557,130,206,430,392,6379,60985,null,,,-21,-3,-24,154,53,23,206,4334
2020-04-09T17:00:00,ITA,9,Toscana,43.76923077,11.25588885,1038,256,1294,4409,5703,146,173,441,408,6552,65461,null,,,-28,-4,-32,178,11,16,173,4476
2020-04-10T17:00:00,ITA,9,Toscana,43.76923077,11.25588885,1011,256,1267,4555,5822,119,175,451,454,6727,72001,null,,,-27,0,-27,146,10,46,175,6540
2020-04-11T17:00:00,ITA,9,Toscana,43.76923077,11.25588885,997,237,1234,4758,5992,170,231,499,467,6958,75756,null,,,-14,-19,-33,203,48,13,231,3755
2020-04-12T17:00:00,ITA,9,Toscana,43.76923077,11.25588885,983,238,1221,4941,6162,170,277,578,495,7235,78640,null,,,-14,1,-13,183,79,28,277,2884
2020-04-13T17:00:00,ITA,9,Toscana,43.76923077,11.25588885,992,225,1217,5040,6257,95,155,615,518,7390,80889,null,,,9,-13,-4,99,37,23,155,2249
2020-04-14T17:00:00,ITA,9,Toscana,43.76923077,11.25588885,1002,225,1227,5125,6352,95,137,637,538,7527,82269,null,,,10,0,10,85,22,20,137,1380
2020-04-15T17:00:00,ITA,9,Toscana,43.76923077,11.25588885,977,216,1193,5224,6417,65,139,693,556,7666,86348,null,,,-25,-9,-34,99,56,18,139,4079
2020-04-16T17:00:00,ITA,9,Toscana,43.76923077,11.25588885,940,213,1153,5460,6613,196,277,745,585,7943,91651,null,,,-37,-3,-40,236,52,29,277,5303
2020-04-17T17:00:00,ITA,9,Toscana,43.76923077,11.25588885,898,207,1105,5478,6583,-30,167,925,602,8110,96231,null,,,-42,-6,-48,18,180,17,167,4580
2020-04-18T17:00:00,ITA,9,Toscana,43.76923077,11.25588885,883,198,1081,5389,6470,-113,127,1149,618,8237,99903,null,,,-15,-9,-24,-89,224,16,127,3672
2020-04-19T17:00:00,ITA,9,Toscana,43.76923077,11.25588885,852,192,1044,5452,6496,26,135,1239,637,8372,103975,84620,,,-31,-6,-37,63,90,19,135,4072
2020-04-20T17:00:00,ITA,9,Toscana,43.76923077,11.25588885,850,182,1032,5536,6568,72,135,1272,667,8507,105857,85946,,,-2,-10,-12,84,33,30,135,1882
2020-04-21T17:00:00,ITA,9,Toscana,43.76923077,11.25588885,833,171,1004,5618,6622,54,96,1295,686,8603,109925,87717,,,-17,-11,-28,82,23,19,96,4068
2020-04-22T17:00:00,ITA,9,Toscana,43.76923077,11.25588885,820,174,994,5173,6167,-455,97,1828,705,8700,114100,91747,,,-13,3,-10,-445,533,19,97,4175
2020-04-23T17:00:00,ITA,9,Toscana,43.76923077,11.25588885,791,168,959,5212,6171,4,80,1886,723,8780,118177,94426,,,-29,-6,-35,39,58,18,80,4077
2020-04-24T17:00:00,ITA,9,Toscana,43.76923077,11.25588885,738,159,897,5236,6133,-38,97,2002,742,8877,121336,96180,,,-53,-9,-62,24,116,19,97,3159
2020-04-25T17:00:00,ITA,9,Toscana,43.76923077,11.25588885,687,166,853,5293,6146,13,138,2109,760,9015,125495,98753,,,-51,7,-44,57,107,18,138,4159
2020-04-26T17:00:00,ITA,9,Toscana,43.76923077,11.25588885,677,158,835,5234,6069,-77,132,2300,778,9147,127394,99751,,,-10,-8,-18,-59,191,18,132,1899
2020-04-27T17:00:00,ITA,9,Toscana,43.76923077,11.25588885,671,154,825,5158,5983,-86,32,2401,795,9179,129048,100869,,,-6,-4,-10,-76,101,17,32,1654
2020-04-28T17:00:00,ITA,9,Toscana,43.76923077,11.25588885,619,144,763,5133,5896,-87,52,2524,811,9231,133617,103891,,,-52,-10,-62,-25,123,16,52,4569
2020-04-29T17:00:00,ITA,9,Toscana,43.76923077,11.25588885,576,139,715,4948,5663,-233,61,2802,827,9292,137482,106150,,,-43,-5,-48,-185,278,16,61,3865
2020-04-30T17:00:00,ITA,9,Toscana,43.76923077,11.25588885,546,126,672,4912,5584,-79,60,2926,842,9352,141849,108596,,,-30,-13,-43,-36,124,15,60,4367
2020-05-01T17:00:00,ITA,9,Toscana,43.76923077,11.25588885,520,124,644,4729,5373,-211,93,3218,854,9445,146456,111349,,,-26,-2,-28,-183,292,12,93,4607
2020-05-02T17:00:00,ITA,9,Toscana,43.76923077,11.25588885,519,118,637,4728,5365,-8,80,3297,863,9525,148223,112437,,,-1,-6,-7,-1,79,9,80,1767
